-----------------------------------------------------------------------------------------------------------------------------------------------------------------------------------------------------------
----------------------------------------------------------------------------------------------------------------------------o------------------------------------------------------------------------------
------o------------------o---------------------------------------------------------------------------------------------------------------------------------------------------------------------------------
----------------------------------------------------------------------------------o-------------------------------------o--------------------o-----X-X-----------------------------------------------------
---------X---------------------------------------------------------------X--------------------------------------------------------------------------------o--o-----------------------o------X--------------
--------------------------------------------------------------X------------------------------------------------------------------Xo--------------------------------------------------------------o---------
-------------------------------------X-------------------------------------------o------------------------------------------------------------X------------------o-----------------------------------------
---------------------------------------------------------------------------------------------------------o-------------o-------------------------------------------------------------------------------v---
---oX---------------------------------------o----XX?XXX---------------------------XXXX-------------XXXXXXXX----------T------------------XXXXXX---------------------------------------------------------f---
------------------------------------?-----------------------------------------o------------------------------------XX|X--------------------------------------------------------------------------------f---
----o--------------------------------------------------------------------XXX-----------------------------------------|-XXXX---BBBBBBXX-B---------------------------------------------------------------f---
---------?--------------------------------------------------------------T--------------------------o-----------------|--------------------------------XXX--------------------B-------------------------f---
-------------------------------------------------XXX-XXXXX--------------|-XB---------------------------------------XX|XXX------------------------------------------------------------------------------f---
----------------------------------X---------------X---------------------|--------------------------------------------|--------------------------------------o------------------------------------------f---
m-----------E---------------------------------E-------E-----------------|--------------------------------------------|E-------------------------E---o---------------E----------------------------------X---
XXXXXXXXXXXXXXXXXXXXXXXXXXXXXXXXXXXXXXXXXXXXXXXXXXXXXXXXXXXXXXXXXXXXXXXXXXXXXXXXXXXXXXXXXXXXXXXXXXXXXXXXXXXXXXXXXXXXXXXXXXXXXXXXXXXXXXXXXXXXXXXXXXXXXXXXXXXXXXXXXXXXXXXXXXXXXXXXXXXXXXXXXXXXXXXXXXXXXXXXXXX
