-----------------------------------------------------------------------------------------------------------------------------------------------------------------------------------------------------------
---------------------o---------------o---------------------X-------------------o------------------------o----------------------?-----------------------------------------------o---------------------o-----
---------------------------?----------------------------X------------------------------------o------------------------------------------------------------------------------o-------o-o---------o----------
------------------------------------------------------o----------------o-------------------------o---o---------------------o---------------------------?---------------------------------------------------
-------o-----------------X-----X----------------------------B------------------------------------------------------------------------------------------------oo--------------------------------------------
-----------B-?------------------------------------o--------------------oB------------------------------------------------BBBBBB----o--------------------------B---------------X----------------------------
---------------X------------------------------------------------------------------------------?---------------?----------------------------------------X-----------X----------------------o----------------
------------------o---------------------------------o-X-------X-----------X----------------------------------X---------XXXXXXX-----------------------------------------------B------------o------------v---
--------o--------------o------o-----X-----------X-----T-------------o--------------------------o------o---------------T----------------X----------T---------------o----------------o-----------X-------f---
---X--------------------------------------------------|----------o-----------------oo-------------------T---------o---|o--------------------------|-----------------o--------X-------------------------f---
---------------X-------------------------o-------o----|--------------o-----------------------------T----|-----T-------|--------o------------------|--T--T-T---oT---------------------------------B-----f---
------------------BBBBB-----------B------------XBBBX-B|XBBBXB------------------T--B---------XXXXX--|--BX|XBBB-|------BT------o-------------------B|--|--|-|-T--|----o-X----------------o---------------f---
------------------------------------------------------|------------------------|-TT---o----------o-|----|-----|------o|-----------X---T-----------|-T|--|T|-|o-|---------------------------------------f---
-------------------------------------o-----------X----|-------------------o----|-||-----------X----|----|-----|-------|---------------|-----------|-||--|||-|--|----------------X----------------------f---
m------------------E----------------------------------|---------E--------------|-||----------------|----|-----|-------|---------------|-----------|-||--|||-|--|--------------------E-E----------------X---
XXXXXXXXXXXXXXXXXXXXXXXXXXXXXXXXXXXXXXXXXXXXXXXXXXXXXXXXXXXXXXXXXXXXXXXXXXXXXXXXXXXXXXXXXXXXXXXXXXXXXXXXXXXXXXXXXXXXXXXXXXXXXXXXXXXXXXXXXXXXXXXXXXXXXXXXXXXXXXXXXXXXXXXXXXXXXXXXXXXXXXXXXXXXXXXXXXXXXXXXXXX
