-----------------------------------------------------------------------------------------------------------------------------------------------------------------------------------------------------------------
------------------------o-----------------------------------------------------o---------------o----------------------------------------------------------------X-----------o----o--------------------------------
--------------------------------X-------------------X-----------o-----------------------------------------------------------------------------------------o------------------------------------------------------
--------------------------o?--B--------------------------------------------------X-------------------------------------------XXXXXX------------------------------------------------------------------------------
------------------------------------------X------------------o-----------------------o-------X--------------X-X----X---------------o--------------------------------------------X--------------------------------
---------X-----------------------X-------------------------X--------X--------------X----?-----------------------------X-X----------------------------------------------------------------------------------------
------------------?----?o----------------------------------------------------o----------------------------------------o-------------------------------------------------------X----------------------------------
---------------------------------------------------------------------?------------------------------------XXXX----XXX-XX-XXXXX---------------------------X--------------X-------------------B----------v---------
-----------o------------------------------------B-------XXX-----------------------------------------------------------------?--X---X-----------------------------------------------------------------X-f---------
---X-------------o----------X---------------------------------BBBBBXB----------------X-B-----------------------------------X-----------------X-o----------------------------X---o----------------------f---------
--------------------------------------------------------------------o------------------------------------------------------------------------------------------------o---------------------------------f---------
-------------------------XBXXX-o-XXXXX-----XXXXXXXX-B--XXX------XXXXX-----------------XXX------X-XXXB--XX-X-o-----X---XXX-----------------------------BBB-------XXX?XXXX-------------------B-----------f---------
----------X-------o------------------------------------------o------------------------o---------------------------------------------------o-------------o---------oX-----------------------------------f---------
---------o---------------------------------------------o--------------------------------------------------------------------------------------o--------------------------------------------------------f---------
m------------------------------------------------E-------------------------------------------E---------------------------------------------------------------------------------------------------------X---------
XXXXXXXXXXXXXXXXXXXXXXXXXXXXXXXXXXXXXXXXXXXXXXXXXXXXXXXXXXXXXXXXXXXXXXXXXXXXXXXXXXXXXXXXXXXXXXXXXXXXXXXXXXXXXXXXXXXXXXXXXXXXXXXXXXXXXXXXXXXXXXXXXXXXXXXXXXXXXXXXXXXXXXXXXXXXXXXXXXXXXXXXXXXXXXXXXXXXXXXXXXXXXXXXX
