--------------------------------------------------------------------------------------------------------------------------------------------------------------------------------------------------------------
-----------------------------------------------------------------------------------------------------------------------------------------------------------------------------------o--------------------------
--------------------------------------------------------------------------------------------------------------------------------------------------------------------------------------------------------------
----------------------------------------------o-------------------------------------------------------------------------------------------------------------------------------o-------------------------------
----------------------------------------------------------------------X---------------------------------------------------------------------------------------------------------------------------------------
-------------------------------------------------------------------------------XXXXX--------------------------------------------------------------------------------------------------------------------------
----------------------------------------------------------------------------o---------------------------------------------------------------------------------------------------------------------------------
--------------------------------------------------------------------------------------------------BBBBB------------------------------------------------------------------------------------------------v------
---------------------------------B-----------------------------------------XX--XXX-------------------------------------------------------???-----------------------------------------------------------f------
-----------------------------------------------------------------------------------------------------BBBB-BB-------------------------------------------------------------------------------------------f------
-------------------------------------------------------------------------------------------------------------------------------------------------------------------------------------------------------f------
---------------------------------B----------------------------------------X-XX-----------BB------XXXX-X-------XXXXX-XX----------XXX--T--XXX------------------------------------------------------------f------
-------------------------------------------------------------------------------------------------------------------------------------|-----------------------------------------------------------------f------
---------------o----------------------------------------------------------------------------------------------------------o----------|-----------------------------------------------------------------f------
m--------------------------E-------o-------------------------------------------------------------------------------------------------|----------------E------------------------------------------------X------
XXXXXXXXXXXXXXXXXXXXXXXXXXXXXXXXXXXXXXXXXXXXXXXXXXXXXXXXXXXXXXXXXXXXXXXXXXXXXXXXXXXXXXXXXXXXXXXXXXXXXXXXXXXXXXXXXXXXXXXXXXXXXXXXXXXXXXXXXXXXXXXXXXXXXXXXXXXXXXXXXXXXXXXXXXXXXXXXXXXXXXXXXXXXXXXXXXXXXXXXXXXXXX
