-----------------------------------------------------------------------------------------------------------------------------------------------------------------------------------------------------------
------------------------------------------?-------------------------X----------------------------------?---------------------------------------------------------------------------------------------------
-----------------o----------------o----------------------------------o--------X----------------------------------------------------o-----------------------------------------------------------------------
--------------------------------------------------------------?----------------------------------------------------------o-----------------X---?-----------------------------------------------------------
-----B-----------------B------------------------------------------------------X--------------------------X----------------B-----?----------------------?---------------------------------------------X-----
--------------------o-------------------------------?X???---------------o---------------------------------------------------------------X---------------o--------------------------------------------------
-----o---------------------------------------------------------o----------------------------------------------------------------------------------------------------------X---------B----------------------
---------o--------------------X------------------------------------?--oX----------------------X--------------------o---?B-BBB--------------------------------------o---X----------------o--------------v---
----------------------------B---------------------------------------------------------------------------B----------------------------------------------------------------------------------------------f---
--------------------------------o----------------oXXXX---------------------------------------------------------Xo------------------------B-------------------------o-----------------------------------f---
-------------------------------------X-----------------------------------------------------o-----------------------------------------------------------------------------------------------------------f---
-----------XXX----------------------------o-----XXX-------T-XXXX-----X?XXXXXXX--------------BBXXX--XXX----T-----------XBBXBBBBB---------------XXXX--?XXXXXXXX--------X---XXXXX?X--o--------------------f---
-----------------------------?--------?-oo-------------o--|--------o---o-?-o-----------o-X---X---o--------|------------------o-----------------------------------------------X-----------o-------------f---
-o--------------------------------------------------------|-----------------------------------o-------o---|---------------------o----------o--------------------o----------X---------------------------f---
m-E--------E---E------------------------------------------|-------------------------------E---------------|-----------------------------E-----------------------------------------E--------------------X---
XXXXXXXXXXXXXXXXXXXXXXXXXXXXXXXXXXXXXXXXXXXXXXXXXXXXXXXXXXXXXXXXXXXXXXXXXXXXXXXXXXXXXXXXXXXXXXXXXXXXXXXXXXXXXXXXXXXXXXXXXXXXXXXXXXXXXXXXXXXXXXXXXXXXXXXXXXXXXXXXXXXXXXXXXXXXXXXXXXXXXXXXXXXXXXXXXXXXXXXXXXX
