-----------------------------------------------------------------------------------------------------------------------------------------------------------------------------------------------------------
---------------------------------------------------------XB--B--------------------------------------------o---o---o---------------X---o--------------------------------------------------------------------
-----------------------------------------------X------o-----------o---------X------------------------------o----------------o----------------------o-----------------------------------------X-------------
-----------------oo-----------B-----------------------------------------B-BX--------------------------X-XX-----------------------------o--o------------------------------------------------------o---------
-----B----?----X--------------------X----B---------------X----------B-------------------------------------o---------------------------------o----------------------B--BBXB---------------------------------
---------------------?------------------------o------X-----------------BBB----B--------B-B------B-B----B-----------X---X--XX?---------X--BBBX----------?---------------------------X-?--o------------------
---------------------------------o------------------------------------------------------------------------------------------------o--------oE----------------------B-----X----------------X----------------
---B-------------------B------XXBBBB---o------------------------------------XB--------------X-XX---o-------B----------o--B-B--------BBBB-B-BB-B-B------------o-B---B-B--------------o------------------v---
----------o----------X-----X------------o-----------XX--------------------------------------------XXX----------------o-----------o--o---------------------------------X--------------------------------f---
-------------------------o-BBX------------------------X--------X----BB-------X-X---------------------------------B---BBBB----B---o-----X-XX-----BBB-BB------B------o---o-------X----X------?-----------f---
-----------------X-------T-------o------------------o--------------------------T-o-------------------------------o-----T----oo-------o-----------------------------------------------------------------f---
------------------------B|BBXBB------X--------BB---BB----------------BB----B--B|------------B--BB?--XB--BX-BBX--XXX---B|----BX---BB-X-XX--------?X?------o----BB?B-------------------------------------f---
-------------------------|-T--------------------------------------------------o|------------------------o-------T------|o-----B-T-----------------------------T--------------------o--o----------------f---
-------------------------|-|o-----------o-------------------------------o------|--------------------------------|----o-|--------|-----------------------------|----------------?-----o------X----------f---
m-E----------------------|-|---------------E-----------------------------------|--------E-----------E-----------|------|--------|----E------------------------|----------------------------------------X---
XXXXXXXXXXXXXXXXXXXXXXXXXXXXXXXXXXXXXXXXXXXXXXXXXXXXXXXXXXXXXXXXXXXXXXXXXXXXXXXXXXXXXXXXXXXXXXXXXXXXXXXXXXXXXXXXXXXXXXXXXXXXXXXXXXXXXXXXXXXXXXXXXXXXXXXXXXXXXXXXXXXXXXXXXXXXXXXXXXXXXXXXXXXXXXXXXXXXXXXXXXX
