-----------------------------------------------------------------------------------------------------------------------------------------------------------------------------------------------------------
-------------------------------------------------------------------------------------o------------------------------------------------------------------?--------------------------------------------------
---o--------------------------------------------------------------------------------------------------------------------------o----------------------------------------------------------------------------
------------------------------------------------?-------o--------------------------------------------------------------------------------------------------------------------------------------------------
--------o-----------------------B--o------------o-----------o--------------------X-------?-------------o-------------------------------------------------------------------------------o-------------------
------------------------------------------------o-----------------------------------------------o--------------------X---------------------o---------------------------------------------------------------
--------------------------X---------X---------------------------------------B------------------------------------------------------------------------------------------------------------------------------
--------?---------------------------------------------XXXXX------------------------B-------------------------o---o----------------------o--------------------o-----------------------------------------v---
--------------------------------------X-----------------------T---------------------------XXXX-------------------------X---------------------------XXXXXXXX--------------------------------------------f---
----------------------------------------------------XXX-------|------------------------------------------------------o------------------?---------o------------------X---------------------------------f---
-------------------------------------o------------------------|-----------------T---X-------------------o----------------?---o-----------------------------------------X--------------------o------o---f---
----------o-----------o--------------XXX------------XXX----XXX|----XXXXXXXX-XXX-|---XXXX?XX---XXXXX-----------------------XXXXXB-XXXXXX----XXXX----XXXX----------------------o------o------X-----------f---
-----------------o-----------------------------X---?----------|------------oo---|------o---------------------------------------------------------------------------------------------------------------f---
--------------------o-----------------------------------------|----o-----o------|----------------o-----------------------o-------------------------------------o----------------o-----------XB---------f---
m-E---------------------------------------------E-------------|-----------------|--------------------------------------------------------------------------------------------E-------------------------X---
XXXXXXXXXXXXXXXXXXXXXXXXXXXXXXXXXXXXXXXXXXXXXXXXXXXXXXXXXXXXXXXXXXXXXXXXXXXXXXXXXXXXXXXXXXXXXXXXXXXXXXXXXXXXXXXXXXXXXXXXXXXXXXXXXXXXXXXXXXXXXXXXXXXXXXXXXXXXXXXXXXXXXXXXXXXXXXXXXXXXXXXXXXXXXXXXXXXXXXXXXXX
