-----------------------------------------------------------------------------------------------------------------------------------------------------------------------------------------------------------
-----------------------------------------------------------------------------------------------------------------------------------------------------------------------------------------------------------
-----------------------------------------------------------------------------------------------------------------------------------------------------------------------------------------------------------
-----------------------------------------------------------------------------------------------------------------------------------------------------------------------------------------------------------
-----------------------------------------------------------------------------------------------------------------------------------------------------------------------------------------------------------
-----------------------------------------------------------------------------------------------------------------------------------------------------------------------------------------------------------
-----------------------------------------------------------------------------------------------------------------------------------------------------------------------------------------------------------
-------------------------------------------------------------------------------------------------------------------------------------------------------------------------------------------------------v---
--------------------------------------------------o---------------XXXXX--------------------------------------------------------------------------------------------------------------------------------f---
-------------------------------------------------------------------------------------------------------------------------------------------------------------------------------------------------------f---
-------------------------------------------------------------------------------------------------------------------------------------------------------------------------------------------------------f---
-----------------------------------------XXXXXXXXXXX---------XXXXXXXXXXXXX-------XXX---------------------------????-----------------XXXXXX------------XXXXXXXXXXX--------------------------------------f---
----------------------------------------------------------------------------------------------------------T--------------------------------o-----------------------------------------------------------f---
----------------------------------------------------------------------------------------------------------|-------------------------o------------------------------------------------------------------f---
mE----E----------------E-----------------E-------------------------------------------E--------------------|--------------------------------------------------------------------------------------------X---
XXXXXXXXXXXXXXXXXXXXXXXXXXXXXXXXXXXXXXXXXXXXXXXXXXXXXXXXXXXXXXXXXXXXXXXXXXXXXXXXXXXXXXXXXXXXXXXXXXXXXXXXXXXXXXXXXXXXXXXXXXXXXXXXXXXXXXXXXXXXXXXXXXXXXXXXXXXXXXXXXXXXXXXXXXXXXXXXXXXXXXXXXXXXXXXXXXXXXXXXXXX
