------X-B-T-----------B----ME--X----------|--------M----TB-----------|-|----M----o---------B----X-------EBo---|X----X----T----M--MTMB-E---E------?-T--------------ME-T---BB---|-----E-------------o-X---
---oo-------|---o-------B--------X-o-?-EM---------X-----T-T---M-E-M-XXMM-|-T-M---------MM-----X--T-----|?-?--M-----?------E--T----o-------E--E---B--------------------------M-T-T----------------EE-----
-o--o--------E--oBB-B------o---X--MT-------o-T-----------B-E-------?-----||M-----??-----T-?|---X-----o--?---T-X-M-----BM-oBM-M-oT-----MT---?----?---------------BB-------------?-E---oTo-|----------M---
---o-----T-------?---|------|---T------oE------------E--E-E------T----BM---M--------EM---B--o------?--------E--o----X---TX-----T-----|--------?TX-o-X-TM--o---E?--------X--X-----o--EM-X------?|B---TE--
------X?-?||X--EE----------?-X-X---M-ME----M-B------T|--T---------|--oX-o-----------E-|----|B----M---------------------B------------------|--X-------M--?-----|--------T------T------o----X--X----------
--------X-----o------------?-----------|--?---?-|-----------M-M-------?---X-TE-------------E------ME---------||----?---X--?--E--------|-----EE|---E------------------|--E---M-------E-------M----X--Xo--
----T-----B|M---BT-?---E----T?-?---XB--------o-------E-|--X------Bo--|E-----TM-T--M------T?B-----T?-----|--------|--|-M---?-----?-----------|----T--X---------T--X-------|-TT---?---E-|---|X-B----------
-------E----------|--X--X-----o-----?--------------BE---?------?-|-||--------M------|--|E------B-B--TM---B----|-------T------T---T--M-M-X-B------X-?------TTX--------TT--T-T-?-----B---------X-----M--Bv
--|E-T---Mo--Mo--T----T--o----?--X---M----|?MT-------Xo-BE--------B--o---??--X|--?T---B----E-----o---B-o--------------------M------E-------ME---|o----T--------?T-E?-B---E----X-------------------?--MTf
-----E-?--------B--?--BT---EM--X-T--------|-B?----B----|-o---T---T-----B-----o------X----E-X---E|-----T?---B---X?-oX----E----MX--T-E-M--T------|-M---------MX|---------T--------T-o--?-M-----T---------f
-----T---E----E-----------T-B--------E--TE-E-?------B--------------?-M--M----B--------BEM---------------------B--o-B--B-MX-M?-----E---X-------BX--------M-?o-----EB-?---EM------M--------|--X--T--MT-E-f
-o------?--|-M----------M--o--T-----|--?--|B-Moo-?-B|BX?----?---------o---|T?--M-----o-E-------XB------|----E--MT-----BM------M----------------E---BTMoM|--E-|-?----o-----------?---?---------T-T------f
-oM--?----M--|-----o------------B------E----------E-------M-----TB|--o-|-?-----E---??--------X-M-T-------o------o------X------T--X--?-----------------X--T---------o-----?--B--------------|E--ME------f
-------EE-X---X------------o|T?-?-M----X?---?M----------|------------M---ET-----|--T-o--XT-------E---TM----B---?------T--B---M---M|-T-Bo-----B--Xo-|--EX---------E-M---------o|------o-----XME-o|----M-f
mX-E--------T-----X-B------?--o-------T--E---T-B-E---E----------------o--o--M-----oB--??-B--X------------T------X---|-BT---X----X--??-------o|-E-|--------?-----E?E-----E---M------MB---?-----MT-o-|---X
XXXXXXXXXXXXXXXXXXXXXXXXXXXXXXXXXXXXXXXXXXXXoXXXXXXX-XXXXXXXXXXXXXXXXXXXXXXXXXMXXXXXXXXXXXXXXXXXXXXXXXXXXXXXXXXXXXXXXXXXXXXXXXXXXXXXXXXXXXXXXXXXXXXXXXXXXXXXXXXXXXXXXXXXXXXXXXXXXXXXXXXXXXXXXXXXXXXXXXXX
