-----------------------------------------------------------------------------------------------------------------------------------------------------------------------------------------------------------
-----------------------------------------------------------------------------------------------------------------------------------------------------------------------------------------------------------
------------------------------------------------------------------------------------------------------------------------?-------------------------------------o--------------------------------o-----------
------------o---------------------------------------------------------------------------------------------------------------------------------------------------------------o--B---------------------------
----------------------------------o----------------------------------------------------------------------X-------------------------------------------------------------------------------------------------
-o------------------------------------------------------------------------------------------------X------------------o-------------------------o-----------------------------------------------------------
------------------------------------------o------------------------------------------------------------------------------------------------X---------------------------o-----------------------------------
-----------------------------------------------------------------------------------------------------------o-----?------------------------------------------------X------------------------------------v---
-----------------XXX--------------XXXBXXXX-------------------B---------XXXXXXXX----XXXXXX------------------?XX-----------------------------------------------------------------------------------------f---
--------------------------------------------X-------------o---------------------------------------------------------------------------------------X--BBBB?B-------------------------X------------------f---
-------------------------------------------------XXXXXXX---------------------------------------------------------------------------E------X???----XX-----------------o---------------------------------f---
----------X-----------------------------------------------------------------------------T--------------------------------------BXXXXXXXXX--------------------------------------------------------------f---
--------------o--------------BBBBB------------------------------------------------------|----------------oo-----XXXXX----------------------------X-----------------------------------------------o-----f---
----------------------------------BXBBB---------------------------o----------XXXXXXX----|------------------B----------------------o--------------------------------------------------------------------f---
m---------------------------------------------------------------E-----------------------|--E--------------------------------------------------------------------E--------------------------------------X---
XXXXXXXXXXXXXXXXXXXXXXXXXXXXXXXXXXXXXXXXXXXXXXXXXXXXXXXXXXXXXXXXXXXXXXXXXXXXXXXXXXXXXXXXXXXXXXXXXXXXXXXXXXXXXXXXXXXXXXXXXXXXXXXXXXXXXXXXXXXXXXXXXXXXXXXXXXXXXXXXXXXXXXXXXXXXXXXXXXXXXXXXXXXXXXXXXXXXXXXXXXX
