-----------------------------------------------------------------------------------------------------------------------------------------------------------------------------------------------------------
-------------------------------?----------------o-----------------------------------------------------------------o-------------------------o--------------------------------------------------------------
-------------------------------------------------------------------------------------------o---------------------------------------------------------------------------------------------------------------
---------------------X-------------------------------------------------------------------------------------------------------------------------------------------------------------------------------------
---------------------------------------------------------------------------------------------------------B--------------------------------------------------------X----------------------------------------
-------------------------------------------------------------------------?---------------------------------------------------?-----------------------------------------------------------------------------
-----------------------------------------------------------------------------------------------------------------------------------?-----------------------------------------------------------------------
----------------------------------B--------------------------------------------------------------------------------------------------------------------------------------------------------------------v---
----------------------------X----------------------------------X-----------------------------------X------------------XXXXXXXXXXX--BBB------------------X-----------------------------------------o----f---
------------------------------------------------------------XXBXXXT--------------XXXXXXX----XXXXXXX----------------BBBBBB--------------------------------------------------------o---------------------f---
--B---------------------------------------------X-----------------|-----T------------------------------BBBB------------------------------------------------XXXXXXX-------------------------------------f---
----------------------?-------------------------------------XXXX--|-----|-----------------------------------------------------------------o-----XXXX---------------------------------------------------f---
--------------------------------------------------------T---------|-----|------------------------------------------------------------T-------------------------------------------------?------------o--f---
-------------------------B----------------------XXXXXX--|---B-----|-----|??????---XXXXXX---------------------------------------------|-------------o---------------------------------------------------f---
m--------E-------------------------------------E--------|---------|-----|--------------------------------------------------------E---|-----------------------------------------o-----------------------X---
XXXXXXXXXXXXXXXXXXXXXXXXXXXXXXXXXXXXXXXXXXXXXXXXXXXXXXXXXXXXXXXXXXXXXXXXXXXXXXXXXXXXXXXXXXXXXXXXXXXXXXXXXXXXXXXXXXXXXXXXXXXXXXXXXXXXXXXXXXXXXXXXXXXXXXXXXXXXXXXXXXXXXXXXXXXXXXXXXXXXXXXXXXXXXXXXXXXXXXXXXXX

