-----------------------------------------------------------------------------------------------------------------------------------------------------------------------------------------------------------
-----------------------------------o------------------------------------------------------------------------o------------------------------------------------------------------o---------------------------
-----------------------------------------------------------------------------------------------------------------------------------------------------------------------------------------------------------
------------------------------------------------------------------------------------------------------B----------------------------------------------------------------------------------------------------
----------------------------------------------------------?-----------------------------------------------------------------------------------------------------------------------o---------------B--------
-----------------------------------------------------------------------------------------------------------------------------------------------------------------------------------------------------------
--------------------------------------------------------------------------X-------------------------------------------------------------X------------------------------------------------------------------
-----------o-------------------------------------------------------------X-----------------------------------------------------------------------------------------------------------------------------v---
---------------------------------------------------------------------------------------------------XXXXXXXX-----------------XXXXXXX-----------X--------------------------------------------------------f---
-----------------------------------------o-----o-------o----?------------XXXXXX--------XXXXX?X---------------------------------------------------------------------------------------------------------f---
--------?---o----X-------------------------------------------------------------------------------------------------------------------------------------------------------------------------------------f---
-----------------XXXX----------------------------------------------------------------------------------------------------------------------------------------------XXX?XX------------------------------f---
-----------------------------------------------XXXXXXX-BBBBBXB----T--------------------XXXXXXXX------------------------------------------o--B---------------------------------------------------o------f---
----------------------------------------XXXXXX--------------------|---------------------------------------------------------------------XXX------------------------------------------------------------f---
m-------------------------------E---------------------------------|------------------------------------------------------------E----------E-E----------------------------------------------------------X---
XXXXXXXXXXXXXXXXXXXXXXXXXXXXXXXXXXXXXXXXXXXXXXXXXXXXXXXXXXXXXXXXXXXXXXXXXXXXXXXXXXXXXXXXXXXXXXXXXXXXXXXXXXXXXXXXXXXXXXXXXXXXXXXXXXXXXXXXXXXXXXXXXXXXXXXXXXXXXXXXXXXXXXXXXXXXXXXXXXXXXXXXXXXXXXXXXXXXXXXXXXX
