-----------------------------------------------------------------------------------------------------------------------------------------------------------------------------------------------------------
----------------------------o-----------------X---------------------------o------------------------------------------------------------------------------------------o----------------?--------------------
--------o------------------------------------------------------------------------------------------------------------------------X-----------------------------------o-------------------------------------
---------------------------o-----------------------------------------------------------B--o--------------------X---------------------------------------------------------------------o---------------------
-------------o--------------X----------------------X-------X-------------------------------------------o-----------o-----------------------o----------o--------o-------------------------------------------
-------o-----------------------------X--------------------------------X----------------------------o----------o-o--------------------o----o------X----X------------o----------X----------------------------
---------X-----o----------------------------------------------------o-------------------------?----o--------B-------------------------------------------------------?---------o----------------------------
---------------o-o-----------------o------------?-------------X-----X----------------------------------o-----------------o-------------------------------------?-o-------------------------------------v---
---------------------------------XX-------T-----------------------------------XXXXXX---o--o-------?-------o--------BB----------XXBX?XX?-XXXXXX--------X---------------------------?----------------o---f---
----------------X-------------------------|------------------o-----------?-----------------------?------B------T-------------o----------------------------------------------o--------------------------f---
------------o------------XXX--------------|---------------------------------------------------------o----------|---------------------------------------------------------------------------------------f---
---------------------o-----------o--------|-----o---------X-------o------XXBX-------------------B--XXX---------|--------------XXXX-----------------------------------------B---------------------------f---
-------------------------o---o-----------X|XXX-----------------o------------------------------------T----------|--------------o----XXXXBXXX-o------X-----------o-----------o----------o-------B--------f---
------------------------X---------------o-|------oo-------------------------------o?????XXXXXX------|--X?XXXXX-|X?X----------B------------------------X----------------------------------------o-o-----f---
m-----------------------------------------|----------E-----------------------------------E----------|----------|---E----------------------------------------------------------------E------------------X---
XXXXXXXXXXXXXXXXXXXXXXXXXXXXXXXXXXXXXXXXXXXXXXXXXXXXXXXXXXXXXXXXXXXXXXXXXXXXXXXXXXXXXXXXXXXXXXXXXXXXXXXXXXXXXXXXXXXXXXXXXXXXXXXXXXXXXXXXXXXXXXXXXXXXXXXXXXXXXXXXXXXXXXXXXXXXXXXXXXXXXXXXXXXXXXXXXXXXXXXXXXX
