-----------------------------------------------------------------------------------------------------------------------------------------------------------------------------------------------------------
--------------------------------o---------------------------------------o------o---------------------------X-----------------------------o-------------------------------------o---------------------o-----
---------------------------------------o----------------o-----------------------o------------------------------------------------o------o-----B--------------------------o---------------------------------
-------------------------------------------------------------B--o-----o-------------------------------------------o-------------------o--------------------o-------------o---------------------------------
--------------X-o----o------------------------------------------------------------------------B?-XBB--------------------------------------------o----------------------------X-----------------------------
-----------------------X----------------------------------------------------------o----------------------------------------------------?-----o-------------------------------o---X-------------------------
-------------B--------o-------o----B----------------------------------------------o-----------o-----------------------o-X-----------------------------------------------X---------------------------o------
----------------------------------------------------X----------X------X--------------B------?-------------------------------?o--B-----------o------oX-----------o----------------------------------oo--v---
-------------------o------------------------------------------------------------------------BBB--o-B----------------o-----------?------X------------------------o-----X-----------------o---------o----f---
-------o----------------X---B---------------------o--------------------------------------------------------------------------------------------------------------------------X--B-o--------B-----------f---
--------------------------------------E----------------------------------------------o-------T----------o----o--?--------------------------------------T------------------------------------o--o-------f---
-----------------------------o------BBB---------------X-??B?XBBBBT?oT--BB------T----BB----B-B|----BBB------------T-----T----------To---T-------o-------|-------------------------------o-o------------of---
------------------------------T-------T-T----------T-------------|-o|----------|-T-o-T-------|-T---o---o-----T---|--T-T|----------|-T--|----T------T--T|------T--B--o----------------------?-----------f---
------------------------------|----o--|-|----------|-------------|--|----------|-|---|-------|-|-------------|---|--|-||o-o------X|-|--|-X--|-----?|--||------|------o---------------------------------f---
m----------E------------------|-------|-|----------|-------------|--|----------|-|---|-------|-|-------------|---|--|-||----------|-|--|----|------|--||------|---------------------E-E----------------X---
XXXXXXXXXXXXXXXXXXXXXXXXXXXXXXXXXXXXXXXXXXXXXXXXXXXXXXXXXXXXXXXXXXXXXXXXXXXXXXXXXXXXXXXXXXXXXXXXXXXXXXXXXXXXXXXXXXXXXXXXXXXXXXXXXXXXXXXXXXXXXXXXXXXXXXXXXXXXXXXXXXXXXXXXXXXXXXXXXXXXXXXXXXXXXXXXXXXXXXXXXXX
