-----------------------------------------------------------------------------------------------------------------------------------------------------------------------------------------------------------------
-----------------------------------------------------------------------------X-------------X------------------------------------------------------------------------------------------------o--------------------
-------------------------?-----------------------------------o-o------------------------o-----------------------------------------------------------------o------------------------------------------------------
---------------------------------------------------------------------o---------------------------------------o---------------XXXXXX----------------------------------------------------?-------------------------
-----------------------------------------?-----------------------------------------------------------------------------------------o---oo------------------------------------------------------------------------
--------o-----------X-------?---------------------------o-----------X-------B------------------------?-----------o-?------X----------------------------------------------------------------?---------------------
------------X---X---------------------------------o----------------------------------------------------B--------------------------------------------------------------------?-X----------------------------------
----------------------------------------------------------BBB?BBBB------------------------------XXXX------------------XX?XXXXX---------------------------X--------------X------------------------------v---------
--------------------------------------------------------------------------------------------?--------------X-X-----------------X---X----------------------------o--------------------------------------f---------
-----------------------------------------------------------------o---------------------------------------------------------------------------X------------------------------X-o-----------X------X-----f---------
------------------?-----------o-------o------------------------------------------o-------------------------------oo---X----------------------------------------------o---------------------------------f---------
---------o---XXXXXX-X-------------------XXXX-------------XBXXXXXX-XXX------------XXXXXX--XXXXXXX-X-X-------?X???---XXXX-------------------------------BBB-------XXXXXXXX----------B---------------X----f---------
------------------B-----------------------o--------------------------------------------o------------------------------------o-------------o-------------o---------o-----o------------------------X-----f---------
-----X-------------------------------------------o-----------------------------------o---------------------------------------o------o---------o-----------------------------o--------------------------f---------
m----------------------E--------------------------------------------------------------------------------------------E-E--------------------------------------------------------------------------------X---------
XXXXXXXXXXXXXXXXXXXXXXXXXXXXXXXXXXXXXXXXXXXXXXXXXXXXXXXXXXXXXXXXXXXXXXXXXXXXXXXXXXXXXXXXXXXXXXXXXXXXXXXXXXXXXXXXXXXXXXXXXXXXXXXXXXXXXXXXXXXXXXXXXXXXXXXXXXXXXXXXXXXXXXXXXXXXXXXXXXXXXXXXXXXXXXXXXXXXXXXXXXXXXXXXX
