-----------------------------------------------------------------------------------------------------------------------------------------------------------------------------------------------------------
---------------------------------o-o------------------------------------------X-----------------------------------X--------------------------------o--o-X----------------o---------o-o---------------------
------------------------------------------------o---------------X------------------------------------?---------------------------o------------------------------o------------------------------------------
-------------------------------------------------------o-------------------------------------------------------------------------------------------------------------------o-------------------------------
----------X----------------X---------X---------------------------------------------------------------o-------------------------------------------o---------------------------------------------------o-----
-------------------X-----------------------------o--------------------------------------?--------------------------X-------------------------------------?--------------------X--o------o------------------
-----------------------------------------------------------------------B------------------X-----------------------------o--------------------------o-------------------------------?-----------------------
-----------B------B------------------------?-----------o--o-o--X---------------------------------------X----------------------------B-----o---X-------------------------------------------------o------v---
----------------------------------------o------------------X----------o----------X---------?-------------------------------------------------------------------------------X--------------------------of---
-----------------------------------------------o--X----------T--------------------------------------------------------?-----------------------------------------?--------o--X--------------------------f---
------------------------------------X---------o--------------|---------------?---------------------------------------------B--------------------T----o-------B--------X-------X------X----o------------f---
----X-------B------------T---------------------o-------------|-----------------------X-----o------X-------------------------------------T----T-o|--------------B--------?----------------B-------------f---
-------------------------|------------------------------oT---|-----------------------------------------o---------T----------------------|----|--|--------------T---------------XX--B-------------------f---
-------------------------|-------o-----------------------|---|--------------------------o-o----------------------|----------------------|-o--|--|--------------|--------------B--------------o---------f---
m-o----E-----------------|-------------------------------|---|-----------E------------E--------------------------|----------------------|----|--|-E-------o----|---------------------------E-----------X---
XXXXXXXXXXXXXXXXXXXXXXXXXXXXXXXXXXXXXXXXXXXXXXXXXXXXXXXXXXXXXXXXXXXXXXXXXXXXXXXXXXXXXXXXXXXXXXXXXXXXXXXXXXXXXXXXXXXXXXXXXXXXXXXXXXXXXXXXXXXXXXXXXXXXXXXXXXXXXXXXXXXXXXXXXXXXXXXXXXXXXXXXXXXXXXXXXXXXXXXXXXX
