-----------------------------------------------------------------------------------------------------------------------------------------------------------------------------------------------------------
-----------------o--------o-------------------------X-----------------B-------------------------------------------------------o---------------------------------------------------o------------------------
------------o----------------------o-B------------------------------------------------------------------------------------------------------o--------------------------------------------------------------
----------------------------------------------------------------------------------------------------------------------------X---------------------------o--------------------------------------o-----------
--------B-o------------------------------------------------------------------------------------X--------------------------------------------------------------------X--------------------------------------
--------------B--o-----------X-----------------------------------------X-------------X-------------------------------------o-----X---o---------------B-----------------------------------------------------
---------------o----------------------------------------------------?---o--------------------------o-----------------X------------------o---------------------------------?--------------------------------
--------------------------------o-----------X-----------------------------------------o-------o---o-----------------------o--o------------------------X------------------------------------------o-----v---
------o--------------X--------o---XXX----o------------------------XBXX--o------------------X--------------------------------X------------------------------XXXXXXX--o----B-----------------------------f---
---------------------------------------------------------BBBB----------------------------------------XXXXXX???X??X------o-----X--------------BBB---BBB----XXXB?BXo--------------------o-?--------------f---
--------------------o-------------------------X-----------------------------XXXX-----o---------o---------------------------------------------X-----------------------------------X--B------------------f---
------------------------o-XXX--------------o-----X-------------------------------------------BBBBBBBB--XXXX-------BX?--X---------X----X?XBXX--------------------------X---------------?-------------o--f---
------------------------------------?--XXX----------------------XXXXXXXXXXo--------------------------------------------------o-----o-------------------------------------------------------------?-----f---
-----------------------------------------------o--XXXXXXX---oo--------------------------------------X------o-----------------------o--?---------------------------------------------------X-X----------f---
m-----------------------------------------------------------E---------------------E--------------------------------------------------E---E-------------------------------------------------------------X---
XXXXXXXXXXXXXXXXXXXXXXXXXXXXXXXXXXXXXXXXXXXXXXXXXXXXXXXXXXXXXXXXXXXXXXXXXXXXXXXXXXXXXXXXXXXXXXXXXXXXXXXXXXXXXXXXXXXXXXXXXXXXXXXXXXXXXXXXXXXXXXXXXXXXXXXXXXXXXXXXXXXXXXXXXXXXXXXXXXXXXXXXXXXXXXXXXXXXXXXXXXX
