--------------------------------------------------------------------------------------------------------------------------------------------------------------------------------------------------------
--------------------------------------------------------------------------------------------------------------------------------------------------------------------------------------------------------
--------------------------------------------------------------------------------------------------------------------------------------------------------------------------------------------------------
--------------------------------------------------------------------o-----------------------------------------------------------------------------------------------------------------------------------
-----------------------------------------------------------------------------------------------------------------------------------------------------------X--------------------------------------------
--------------------------------------------------------------------------------------------------------------------------------------------------------------------------------------------------------
---------------------------------------------------------------------------------------------------------------o--------------------------------------------o---------?---------------------------------
---------------------------------------------------------------------------o---------------------------------------------------------------------------------------------------------------------------v
----------------------------------------------------------------------XXXXX---------XXX------------o-------------?-XXXXX-----------o----------------------XXX------------------------------------------f
-----------------------XXX--------------------------------------XXXXXXXXX------------------------------XXXXXXX------------------XXXX-------------------------------------------------------------------f
-------------------------------------------------------------------------------------------------------------------------------------------o--T--------------------------------------------------------f
----------------------o---------------------------------------????????-----XXXXXXX------X------------------------XXXXXXX----------------------|--------------------------------------------------------f
----------------------------T-XXXXXXX-----------------------------------????--X---------------------------------------------------------------|-------------XXX----------------------------------------f
----------------------------|------------------------------XXXX--------------------------------------------------------------????????-XXX-----|----------------------o----------------------?----------f
m---------------------------|-----------------------------------------E----------------------E------------------------------------------------|-------------------------------E------------------------X
XXXXXXXXXXXXXXXXXXXXXXXXXXXXXXXXXXXXXXXXXXXXXXXXXXXXXXXXXXXXXXXXXXXXXXXXXXXXXXXXXXXXXXXXXXXXXXXXXXXXXXXXXXXXXXXXXXXXXXXXXXXXXXXXXXXXXXXXXXXXXXXXXXXXXXXXXXXXXXXXXXXXXXXXXXXXXXXXXXXXXXXXXXXXXXXXXXXXXXXX
