-----------------------------------------------------------------------------------------------------------------------------------------------------------------------------------------------------------
---------------o--X-------------------------------------o--------------------------------------------------------------------------------------------------------------------------------------------------
-------------------------------o-------------------------------------o-------------------------------------------------------------------------------------------------------------------------------------
------------------------------------------------------------------------------------------------------------------------------o--------------------------------------B-------------------------------------
-------------------------------------------------------------------------o---------------------------------------------------------------------------------------------------------------------------------
-------------------------------------------------------------------------------------B---------------------------------------------------------------------------------------------------------------------
--------------------------------------------------------o---------?-------------------------------------------------------------------------------------------------------------------------o--------------
-----------------------------------------------------------------------------o-------------------------------------------------------------------------------------------------------------------------v---
-----------------------------------------------XXX?------------------------------XXXXXX-------------------------------XXXXXXX----------XXX-------------------------B?B?XB----------B-------------------f---
------------------------------------o-------XXXX------------------XX---XXXXXXX-------------------------------------------------------------------------------------------------------------------------f---
------------------------------------------XX-XXX--------------o-----------------------XXXXXXX----------------------?---------------------------------------B-------------------------------------------f---
-------------------------------BBB-----------------------?????-----------------------------------------XXXXXXXXX----XXX-------------------------XXXXX-------------X-XXX---------------------------o----f---
---------------------------------------------------------???????X-------------------------------------E------------------------------------------------------------------------------------------------f---
-------X-----------o------------------------------------XXX--------------------o------------------????????---------------------------------------XXXX------------------o-------------------------------f---
m-------------------------------------------------------------------------------------------E-----E----------------------------------------------------------------------E-------E------------------E--X---
XXXXXXXXXXXXXXXXXXXXXXXXXXXXXXXXXXXXXXXXXXXXXXXXXXXXXXXXXXXXXXXXXXXXXXXXXXXXXXXXXXXXXXXXXXXXXXXXXXXXXXXXXXXXXXXXXXXXXXXXXXXXXXXXXXXXXXXXXXXXXXXXXXXXXXXXXXXXXXXXXXXXXXXXXXXXXXXXXXXXXXXXXXXXXXXXXXXXXXXXXXX
