-----------------------------------------------------------------------------------------------------------------------------------------------------------------------------------------------------------
-----o-----------------------------o-----------------o-------------------------------------B--------------------------BX--------BBB--o---------------------------------------------------------------------
----------------------------------------------------------------------X------------------------------------X-----------------------------B-----------------------------------------------------------------
--------------------------o--------------------------------------o-------------------------------------o---------------------------------------------------------------------o-----------------------------
-----------------------------------------------------------------------------------------------------------------------------------------BBBBBBBB-----------------------------------------------?----------
------------------------X--X------------------XBBBBXB-------------X-------o--BBBBXB--------BBB-X-----o--X-----------------------BBBBB----------------------------------------------------------------------
-----------------------------------------------------------------------------------------o------------BX---------------------------------X------------------------------o-------------------X--------------
--------------X-o-----------------------------BBXBBB-----------------------BBBBBB----------B-----------------------------------------------------------------------------------------------------------v---
----------------------T----------------------------------B--------------------------------------------BB-----------------------BBBBB---BBB--------------------?--------------------o-------------------f---
----------X-----------|-----------------------------T--------------o-----------T----------??????-X--------------B-X---o----------------------------------------------?---------------------------------f---
----------------------|-----------------------------|--------------------------|----------------------------------------------------------------------------------------------X------------------------f---
---------o---?X-BBBXBB|-BBXB----------------B???--BB|B-------------?X????-BBBBB|BB-----T-BBB----------?BBB-----?????--------BBBBBB---BBBB----------o-BXBBBBB--------BBBB----o----------------B--X------f---
----------------------|------------------------o----T-------------------o------|-------|---------------------o------------------------------T----------------------------------------------------------f---
-------------o--------|--o--------------------------|--------------------------|-------|----------------------------------------------------|--------------------------------------------------------X-f---
m---------------------|-----------------------------|--------------------------|E------|----------------------------------------------------|--E-------------------------------------------------------X---
XXXXXXXXXXXXXXXXXXXXXXXXXXXXXXXXXXXXXXXXXXXXXXXXXXXXXXXXXXXXXXXXXXXXXXXXXXXXXXXXXXXXXXXXXXXXXXXXXXXXXXXXXXXXXXXXXXXXXXXXXXXXXXXXXXXXXXXXXXXXXXXXXXXXXXXXXXXXXXXXXXXXXXXXXXXXXXXXXXXXXXXXXXXXXXXXXXXXXXXXXXX
