-----------------------------------------------------------------------------------------------------------------------------------------------------------------------------------------------------------
-------------------------o-----------o----------------------------------------------------------------------oo----------------------------------------------------------------------o----------------------
-----------------------------------------------------------------------------------------------------------------------------------------------------------------------------------------------------------
-----------------o--------------------------------------------------------------B-----------------------------------------------------------------------------------------------B--------------------------
-----------------------------------------------------------------o-------o----------------------------------------------------------------------X----------------------------------------------------------
---------------------?----------o-o----------------------------------------------------------------------------------------------------------B-------------------------X-----------------------------------
---------------oo------------------------?----------------?-----------------------------------------------------------o----o-------------------------------------------?-----------------------------------
-----------o-----------------------o----------------?-----------------------------------------------------------B---o----------------------------------------------------------------------------------v---
----------------------------XXXXXX---------------------------XXXXXXX---------------------------------o-X---------------------------------XXXXX----------------------------------o----------------------f---
------------------------------------------------------------------------o-----------XBBBBBBBXXX-------------XXX-----------------o----------------------------------------------------------------------f---
-----------------------------------XXXXXX-----------------------------XXXXXXXX-------------------------B----------X-------------------------------------XXXXXX-----------------------------------------f---
---------------------------o------------o---XXXX-------------------------------------------------------------------------XXXXXX---------XXX?XXX--T------------------------------?----------------------f---
--X---------------------------------T---------------------o----------------------------------XXXX----------------o-----------XXXXXXX-------------|-----------------------------------------------------f---
----------------------------------o-|---------------------------BBBBBXBB-----------------------------------------------------------------XXXXXX--|-----------------------------------------------------f---
m------E-----------------------E----|-------------------------------------E------------E---------------------------------------------------------|-----------------------E-----------------------------X---
XXXXXXXXXXXXXXXXXXXXXXXXXXXXXXXXXXXXXXXXXXXXXXXXXXXXXXXXXXXXXXXXXXXXXXXXXXXXXXXXXXXXXXXXXXXXXXXXXXXXXXXXXXXXXXXXXXXXXXXXXXXXXXXXXXXXXXXXXXXXXXXXXXXXXXXXXXXXXXXXXXXXXXXXXXXXXXXXXXXXXXXXXXXXXXXXXXXXXXXXXXX
