-----------------------------------------------------------------------------------------------------------------------------------------------------------------------------------------------------------
-----------------------------------------------------------------------------------------------------------------------------------------------------------------------------------------------------------
-----------------------------------------------------------------------------------------------------------------------------------------------------------------------------------------------------------
-----------------------------------------------------------------------------------------------------------------------------------------------------------------------------------------------------------
-----------------------------------------------------------------------------------------------------------------------o-----------------------------------------------------------------------------------
----------------------------------------------------------------------------B-----------------------------------------------------------------------------------------------------------------?------------
----------------------o-------------------------------------------------------------------------------------------------------------o----------------------------------------------------------------------
------------------------------------------------------------------------------------------------------------------------------X------------------------------------------------------------------------v---
---------------------------------------------------------------------??-?---------------------X----------------------------o--o-------------XXX-------------------------------B---o--------------------f---
------------------------------X----------------------------------------------------------------------------------???-----------------------------------------------------------------------------------f---
--------------------------------------T-------BTBBBBBB-------------------------------o-----------X--------------------------------XXXXX----------E-----------------------------------------------------f---
--------------------------------------|--------|--------------------XX?----------------------o-------------------XXXXX----------------BBB-----XXXX----------------B---------?----o---------------------f---
--------------------------------------|-XXXXX-X|?XXXX-----------------------------o---------------------------------T----------------------------------------------------------------------------------f---
-------------------------------XXXX--X|?XX-----|---------XXXXX----XXXXXXX------------?XXXXXXXXXXX----------B---XX---|--------XXXXX---------------------------------------------------------------------f---
m------------E---------------------o--|--------|--------------------------------------------------------------------|-----------------------------------------------------E-----------------------E----X---
XXXXXXXXXXXXXXXXXXXXXXXXXXXXXXXXXXXXXXXXXXXXXXXXXXXXXXXXXXXXXXXXXXXXXXXXXXXXXXXXXXXXXXXXXXXXXXXXXXXXXXXXXXXXXXXXXXXXXXXXXXXXXXXXXXXXXXXXXXXXXXXXXXXXXXXXXXXXXXXXXXXXXXXXXXXXXXXXXXXXXXXXXXXXXXXXXXXXXXXXXXX
