--------------------------------------------------------------------------------------------------------------------------------------------------------------------------------------------------------------
-------------------------------------o----------------------------------------------o-------------------------------------------------o-o---------------------------------------------o----------B------------
--------------------------------------------------------o-------------------------------------------------o-----------------------------------------------X---------------------------------------------------
--------------------------o------------------X--o--------------------------------------------------------o-----------------------------------------o---------?------------------------------------------------
--------------------------------X--------------------B-------------------------o----------BBXBBX-------------------o------o---------o-------------------------------------------------------------------------
-------------?-----------------------------------------------------------BXB------------------------X---------------------X--------X------------o-------------------X-----------------------------------------
------------------------------------?--------------X----------------------------------------------------X-----------------------------------------------------------o-----------------------------------------
-----------B------------o---------o------------X-----X-------o----------------------------X-----------------------------o---------------------o---o------BBBB---------------------------------X--o-----v------
-----------------------------------------------o--X----o---------------------o?-----------?XB--------X----------------------o----------------------------T-------------------------o-------------------f------
-----------------------o---------?---------------------oo----------------XBB---------------------T--TT-------------------X-------------------------------|-------------?-------------o---B-----o-------f------
-------o-------X--X------------------------------------------------------X----------------T------|--||-----------------T----------T--T-T-----o------T----|----o----------------X-----------------------f------
------------------BBBBB-----BXB-T-------T----T-XBB---?????-X--------T--BBBBB--------BB---B|Bo----|BB||B------XXBB---BBB|B-BXBX----|T-|-|--------T-oT|--XB|BBB--T---------------------------------------f------
------------------------------o-|-------|----|----------------------|------------o--------|------|T-||------T--------T-|---------TT|-|-|--T---B-|--||----|-----|---------------------X-----------------f------
--------------------------------|-------|----|----------------------|---------------------|------||-||o-----|--------|-|---X-----|||-|-|X-|-----|--||----|---o-|------------o----------B-----B---------f------
m------------------E---------E--|-------|----|----------------------|---------------------|---E--||-||------|-E------|-|--------E|||-|-|--|-----|--||----|-----|---------------o------------E----------X------
XXXXXXXXXXXXXXXXXXXXXXXXXXXXXXXXXXXXXXXXXXXXXXXXXXXXXXXXXXXXXXXXXXXXXXXXXXXXXXXXXXXXXXXXXXXXXXXXXXXXXXXXXXXXXXXXXXXXXXXXXXXXXXXXXXXXXXXXXXXXXXXXXXXXXXXXXXXXXXXXXXXXXXXXXXXXXXXXXXXXXXXXXXXXXXXXXXXXXXXXXXXXXX
