-----------------------------------------------------------------------------------------------------------------------------------------------------------------------------------------------------------
---------------------------------------------------------------------------------------------------------------------------oB-----------------o------------------------------------------------------------
--B-----------------------------------------------o-------------?------------------------------o-------o--------------------------------------------------------------o----------------------o-------------
-------------------X------------------------?------------------------------------------------------------o-------------------------X-------------------------------X------------------------X--------------
----------------------------------------------------?-------------------BBB------------------------------------------------------------------------------------------------------X-----o-------------------
-------o----------o--------------------------------o-----X-------------------------------------------------------B-----?XX?-------o-o-----------------X----X---?-----X-------------------------------------
--------------------------X-------X------o--------------o-----------------------------------------o-----------o----------------------------------------------------B------------------X--------------------
-B----------------------------------------X----------------------------B---------?--------------?---------o-------BBB--------------X-----------------------------------------------------------o--o----v---
----------------------------------------------------X-----------------------------------------------------------------XXXX----------------------------T------------------------------------------------f---
----o---------------------------------------------o--o---------X----------------------o-o-----------------------------------------o---------------o---|------X--------------o------X-------------------f---
----------------------o---o----------------oo---------------------------------------------X-----------------------------------------o--o-o------------|------------o-----------------------------------f---
-----------------------B----BBB-BBXXXX------------X------X-BBB-BB---BBBB-B--BB-B--------B-B-B------T----------o--X????X-------BB----BBB--------o--?B??|??---X--X----------------------o----------------f---
-------------------o----------------------------------------------------T--o----o------------------|------------T------------------o------------------|-----------------------------B------------------f---
---------------------?------------------------------------------o----o--|--------o-----------------|------------|------------o-----------o-----o------|------------------------------------------------f---
m-E-----------------------------------E---------------------------------|--------------------------|------------|-----------------E-------------------|-----------------E------------------------------X---
XXXXXXXXXXXXXXXXXXXXXXXXXXXXXXXXXXXXXXXXXXXXXXXXXXXXXXXXXXXXXXXXXXXXXXXXXXXXXXXXXXXXXXXXXXXXXXXXXXXXXXXXXXXXXXXXXXXXXXXXXXXXXXXXXXXXXXXXXXXXXXXXXXXXXXXXXXXXXXXXXXXXXXXXXXXXXXXXXXXXXXXXXXXXXXXXXXXXXXXXXXX
