-----------------------------------------------------------------------------------------------------------------------------------------------------------------------------------------------------------
----------X-----------------------B--------------------------------------o-----------------------o----------------------------o----------------------------------------------------------------------------
------------------------------------o---o-----o-----o---------------------o---B-B---------------BX-------------B--?---------o----------------------------------------------------------------B-------------
--------------------o---------o-X---------------------------------------------------------------------oo----------------------B----XB----------------------------------oo----X-------------------o---------
----X------------------------------------------------------------------o-----------------------------------B---B---------------------o----B------oo------------------------------------------o-------------
------X----------B--------X---o------------X--------BB-?XBB-------------o-----------X-B-o-----XXXX--------------B-XX------XX---------------X---B--B----X---------X----oX-------------?---------------------
----------------o-------o----------------------------------------------o-----BB---------------------------B-B--------o------------o--BBB--B----X------o------------B-BB-------------o----------------------
-X-------------------------------------o----------------------------BX-----o---BBB--B---?-----------------------------o--B-B------o-------o----------------------------o-------------------------------v---
----o---o------------------XXX------------------------XX-o--------------------------X???--BXBB-----------------------o------------------B-B-?-----o-------------X-XXo------------?---------------------f---
-o-----------o------o----o-X----------------------------o--------X-XX---------BB-------------o------o-----------B----B-BB-------------------------oB-BB------T------------o----------------------------f---
--o--------------------------------------------------o------------T----------o--o---------------X----------------B-----T---------X---o-------------------X---|-----------------------------------------f---
---o---------------BB-----BBo-BX-XXX-X------o-B-XBBXB--------BB-BB|B----T-BB-B-----X----B-BB---BBBB----BBo----X-X-----B|----B---o-X--B-XB-B------B------B---B|o----------------------------------------f---
-------------------------------------------------o----------o----T|-----|-----o-----------o-------------------o-o------|--------T-------------o--------------|T-------o---------------o----------------f---
--------------------------------o--------------------------------||-----|------o------o------------?-----------------o-|--------|----------------------------||-------o--------------o------X----------f---
m-E----E-----------------------------------E------------------E--||-----|-------E---------E----------------------------|--------|----------------------------||---E------------------------------------X---
XXXXXXXXXXXXXXXXXXXXXXXXXXXXXXXXXXXXXXXXXXXXXXXXXXXXXXXXXXXXXXXXXXXXXXXXXXXXXXXXXXXXXXXXXXXXXXXXXXXXXXXXXXXXXXXXXXXXXXXXXXXXXXXXXXXXXXXXXXXXXXXXXXXXXXXXXXXXXXXXXXXXXXXXXXXXXXXXXXXXXXXXXXXXXXXXXXXXXXXXXXX
