-----------------------------------------------------------------------------------------------------------------------------------------------------------------------------------------------------------
------o---------------------------------------------------------------------------------------------------------------------B------------------------------------------------------------------------------
---------o----------------------------------------o--------------------------------------------o-----------------------------------------------------------------o----o------------------------------------
--------------------------------------------?------------------------------------------------------------o---------------------------------------------------------X------------------------X--------------
---------------o------------------------------------?------------X------BBB------------------------------------------------------------------------------------------------------X-------------------------
---------o----X------------------------------------o-----X-------------------------------------------------------B-----??X?------------o-------------oX----X---?-----X-------------------------------------
--------------------------X-------X------o--------------o-----------------------------------------o-----------oo---------------X-----------------------------------B------------------X-------------o------
--------B---------------------------------X----B-----------------------B------------------------?-----------------BBB----------------------------------------------------------------------------------v---
-----------X-------o--------------------------------X-----------------------------------------------------------------XXXX----------------------------T------------------------------------------------f---
--------------------------------------------------o-oo---------X----------------------o-o----------------------o----------------------------------o---|------X---------------o-----X-------------------f---
-------------X------------o----------------oo--------------------------------X------------X-------------------------------------------B---------------|----------------o-------------------------------f---
-----B-----------------B----BB?-BBXXXX------------X------X-BBB-BB---BBBB-BB-B-BB--------B-B-B------T-------------X??X?X-------BBBBBBBB------------?B?X|??---X-------------------------o----------------f---
------------------------------------------------------------------------T--o-----------------------|------------T-------------------------------------|-----------------------------B------------------f---
----------------------------------------------------------------o-------|--------o-----------------|------------|------------o---------X-o-----o------|------------------------------------------------f---
m------E------------------------------E---------------------------------|--------------------------|------------|-------------------------------------|-----------------E------------------------------X---
XXXXXXXXXXXXXXXXXXXXXXXXXXXXXXXXXXXXXXXXXXXXXXXXXXXXXXXXXXXXXXXXXXXXXXXXXXXXXXXXXXXXXXXXXXXXXXXXXXXXXXXXXXXXXXXXXXXXXXXXXXXXXXXXXXXXXXXXXXXXXXXXXXXXXXXXXXXXXXXXXXXXXXXXXXXXXXXXXXXXXXXXXXXXXXXXXXXXXXXXXXX
