-----------------------------------------------------------------------------------------------------------------------------------------------------------------------------------------------------------
-o--------------------------X----------X-----------------------------------------------------------------o-------------------------------------------------------------------------------------------------
--------------------------------------------------------------o-----------------------------------------------------------------------------------?--------------------------------------------------------
-------------------------------------------------------------------o--------------?----------------------------------------------------------o-------------------------------------------------------------
-----------------?----------------------------------------------------------------------BB-B---------------------o-----------------------------------------------------------------------------------------
-----------------X-----o--------------------o-----------------o-----------------------------------------------------B----------------------------------??-E-------o----------------------------------------
-------------------B-------------------------------------------------o---------------------------o---------------------------------------------?---------B?---------B--------------------------------------
---------------------------------------------------o-----BBBB----------------------------B------BBXB-?-?---------------------------------------------BB-B-------------X--------------------------------v---
----------------------------------------------------------------------B------------B-BBB------------------------------T-------o--------------------------------------------X---------B--------------o--f---
--------------------T----------------------BBB-----------T--------------------------X-------T-------------------------|------------------o----------------T--------B-------------------------X---------f---
--------------------|---------------------E--------X-----|----------------------------------|-------------------------|---------------o-----o-------------|--------------------------------------------f---
----o--------------B|BXBX-X--------------B?BBBBB-----B---|BTB----T-BBBBB-B-----BBB--B----BBB|BX--???X-XXX----BBB---B-B|B-----BBBB---B-XBBBBX--T--ooB-BB--B|BBB----XXo-----------------------X-B--------f---
---o----------------|---------T-----------------------X--|-|-----|--------------------------|-------------------------|-----------T-----------|---T-------|---------------------------------o----------f---
--------------------|---------|--------------------------|-|-----|--------------------------|-----------X-------------|-----------|-----------|---|-------|-------------o--------------------------o---f---
m-------------------|-E-------|--------------------------|-|-----|----------E---------------|-------------------------|-----------|---------E-|---|-------|-----------------------E----------------E---X---
XXXXXXXXXXXXXXXXXXXXXXXXXXXXXXXXXXXXXXXXXXXXXXXXXXXXXXXXXXXXXXXXXXXXXXXXXXXXXXXXXXXXXXXXXXXXXXXXXXXXXXXXXXXXXXXXXXXXXXXXXXXXXXXXXXXXXXXXXXXXXXXXXXXXXXXXXXXXXXXXXXXXXXXXXXXXXXXXXXXXXXXXXXXXXXXXXXXXXXXXXXX
