-----BE--X------E--M--?-----------?B----?-----T---X--X--o----BT---?------------BB-XB--MX-M--oB?----XM-M----?-BMo---|B---E-T?B-E------|-------|----|?-----B-TT-B----T-B?|--------------------?---BEX-----
---|------X-----T---------M-------o|Bo----o-B-----T------------E----BBoTo-----T---o-X-B---------------?----M--o------------o-o--M-?E-E---------?-oE--|Mo---E-M-T---|-------BX-------------BE-------?-B--
-------M-------------EB--EEE-o---o--------o-TT------B----T-------------------------X-?---T---E?-----|-------o-o|---X---T---|----------o?------T-------?o-BB---------------------M-?--B---M-?-?--------|-
-------?-X|--B-?-----?o-----------------B-oT-?-----?-------M-M-----T-oM-X-X-X---E-T-MT-TB--------------X--E------MX---?-T--X--?-------o-?-XT-o--------BB--o-------B--------|--X-|-T---------------------
--XTT--B-?-|-X-----T-----X-?B-------E---E----o--BT--------|---B--MEM--T----|----o--To------X-----E----B-----ME?T-----------B----X-------------?---T|---------E---X-?-?-----|-E|------|----M-B|----------
------o--T---B--M---------|---X|--|oE-T--------|-?E---T---BT--M?--?T------X----------?----Mo-T-----E-----|E------X-----------------------?-o-T-?--|--T-T-------------o?-----M--T-BM---|--o-----------|--
--o---M---------X----B--X----B---|-M---|--Bo-E---------X-T--ME----T-------M----EX-------o-T-?o-X-E----?----------o---B-------M------T?-----------------------------o-----B------------B-----?-X----T----
--M--BoM?-------M---M--?---------------M-----------B--BM-E-X--o----------B-T-?--ToMX----------B----------T-o------------B---M---M----------?o-X---------|------M--|B-B--TM-----?--oB--------M------?---v
-|---o--------X?o-ET--E----|---|---X------X-?---|---M|?T---|E----E-M------M-MEX---|-X-|E--E-T--------------o---B--?-|---|-o-o-|---E-TB---E----o------Eo----|T-----BB-o-----|--?--T-----------M-TMB----Ef
---|--|---T--o-M--BT-TBoo--------M|B--o--------------?|-----oM----------------T----XE----E---M-------BB--?-?---X-T---B----|--|?-XE-o-------T-------T-MM---?---?--B---T-EX--E----T------|---o---X|X-----f
----o-----|---B-?---------X-M----------T--E----E-B--|--------?o----X---------E---E-------------------M------------?--------X-T-------TT-?o--X--X-E--E----T-----E----M-XE--T---|--|TT---T---B-M--------?f
---X-X----MT--|-o------?---T--------------M---o--------T|---|-----B---T-|B--|--------o--B---M--o---??----?o----o---|---------|T?-M-?----|------------E----------?------?---??-----M-X---B--------E-E?--f
----T-----?|M---X---B----------E--------------MM---|---E|---?--------E---B-XE----BT-----X----------M-------B-----------E----B------M----?-TM-o--T-------|------E-|--------EM-----?-----------|--B-X--|Tf
--o-B---B---X-E-------E----------------------X------TXM|---X-----B-X---E-----E-MX-o------E-|-X-XBM----------?--------E-B-----oX--BX-M--X---?----M----B-----B--?--X------TM--E--T------o--|--E-E--o---|-f
m------------------------------------------------------------------------------------------------------------------------------------------------------------------------------------------------------X
XXXXXXXXXXXXXXXXXXXXXXXXXXXXXXXXXXXXXXXXXXXXXXXXXXXXXXXXXXXXXXXXXXXXXXXXXXXXXXXXXXXXXXXXXXXXXXXXXXXXXXXXXXXXXXXXXXXXXXXXXXXXXXXXXXXXXXXXXXXXXXXXXXXXXXXXXXXXXXXXXXXXXXXXXXXXXXXXXXXXXXXXXXXXXXXXXXXXXXXX
