------B------|----|-------M-------------------||--oEXTT---E--M------B------o---EX--o------X-?-MXBM--MXToT-?--M------Boo----B------Boo--o-----M-T-----o---o-X-------X----T--T---X----BM-------o|--M-M----
----B-------MB-X------o---o--|--MX--E----M-------E-X?-----BXT------------T----TE----------------B-------oB--------X-B---------BT-----E-X?---------------B--o---------T|--|-ME---MMM-M------T-|X---------
-?-----|---M-M--------o--B-|---|--T------o---T--o----E-|----?--B---?E-----T----oE-?-XXT--B-X------o-------B----------X-----B-----B-----TE?---|-T----Mo-EEo--|----X--oo--E------------?-T-----X-M-?-o----
-T------------M-?--E|--?o----------|------B--------?-?----------B-------X--?T?-----E----------M------?--X---o------------E-M--|-------B?-T---------E?-----X--T-Xo-o---B---E---B-------------XB----|-?BM-
---|---------TM|--Xo----T?------------------T--?-E-|----M-?M|M------------------|-T--M----T-o---?---M--X--T---X--X---E-B------X---M------M---B------|--oE----B----------M-?---------o-----|-------------
-------MX---|-----TM-?-?------M-|-T---E-T--E---|-oEE------?--------------X-----T-----E-----M--------|MM-X----------------M--------??---EE------B--?--------?-XT----B-B--B-X----X--T?-X---|---B--X---E---
-|-----T-?--------M----------E-o-?----?--------?--------B------|T|--------o--------------------|--T-----Bo-M----?--X----B----E|---B---M-|-o---E|---o-o---?----B-----T-X------T|-B------E--T---M---------
--M--------E--oX-o-----------TX-E-T---------o--------EB-----------------------o-XE|o----B----|EX---T----M---E-------E-o------|-XB-----M--o-----------------?--------o--E-------B-------------M------o--v
--------E----|---T--o-E------oo-?-?-----o-TT---------M--E----------E----B-X--------X-MT-B-o-oo-X-----------M--|B-|-------o--EB-------o--?-E---B--XM----Mo-B----E------M---B--|--------|-X--|-------??M-f
-----EMM----?----M---------o-M---B-T-----M---M----oB--X---?BM--B----T----?-X-o---X-E----B--------?|---oX-?------X----o-------T-T---T-|--X---|-------M------o-BM--------?------------X-----------T?---T-f
---T-E-----o---?---E-E---------------B--------M-B---------------------|--?----X-BM---B----M-MXT-E---------?----|-----o-E----X-|---|---E---o--|----B-------------------X--oo-E|--E------ME------T---X--Mf
---E----?--X--Mo---o------------|E----------X---?BTT-B?-------------T----o----TE------T-o-|-?-M-------M|---T|---o--------X--B-B|--MMB-------M---------E-|-M--MT-T----M---X-X----------------------B--M-f
-B---?MB-----?---------|-o-----------?------|T-o-M----BX----M---------B-?-MME--T-------E-----M-------E-----B--X---M|---------------T--E--X--M--?--|------------?-----E------M---o----M?-E-B------B--BT-f
------------B-B-X----TE----o-M-o-E--||-----o-------o------------?-E-B-|---|B-Xo---o------B-T-----------E--B-------TE---------T------|----|---B----X--BX---M--B---E-E----?T--E-X?-M-o---X--X|-----------f
m--------o---E--oo?-X-M----M-B-?--------M-o---T--E-------M---o|-----E--M-E------T-----------|--|---------XB-----M----E-------?-X?T-o---M----------------T-o-X----?-T---M--T-E-T----B---|----T---XE----EX
XXXXXXXXXXXXXXXXXXXXXXXXXXXXXXXXXXXXXXXXXXXXXXXXXXXXXXXXXXXXXXXXXXXXXXXXXXXXXXXXXXXXXXXXXXXXXXXXXXXXXXXXXXXXXXXXXXXXXXXXXXXXXXXXXXXXXXXXXXXXXXXXXXXXXXXXXXXXXXXXXXXXXXXXXXXXXXXXXXXXXXXXXXXXXXXXXXXXXXXX
