-----------------------------------------------------------------------------------------------------------------------------------------------------------------------------------------------------------
-------------------------------------o----B----------------------------------------------------------------------------------------------------------------------------o-----------------------------------
------------------------------o----------o-o---------------------------o-----------------------------------------------------------o---------------------------o---o-----------o-----------------X---------
----------------------------------------o--------------------------------------o--o--------------------------------------------o----------------------------------------------------------o----------------
------------X-------------X----------X---------------------------------------o-B--------------B---------o----------------------X--------o---------------X------------------------o-----------?-----?-------
-o--------------------------------ooX-----------------?--o--------------X---------------------------------o--------------o-------oo----------o---?---------------Bo--o-----o-------------------------------
---------------?---------------------------------------------?-------------------------------?----------X-------------------------------------------------------------------?------------------------------
---------------------------------------------------------------------------o------------------B---------------------------E-------------------------------o?------------------------o----------------X-v---
---B------o----o-?--------B--------------------------------------------T-----------------o---------------------X------X--???---------------X-----------------T---------------------------o-------------f---
--------------------o----o----------T----------oo----------------------|-BBBBBB------------------------TBXBBBB----------------------------------------------o|---------------X----------------o--------f---
------------------------------------|--------o----------o------o-------|-------------E-o---------------|---------------------------------------------------o-|----------------------------B------------f---
----X------------------------------B|B------------XXXX-------------BBBB|BB----XBBBB-BBBB----------BB--B|BBX---------XBB------o-----------------T--------o---B|B----------------------------------------f---
-------------------------------o----|--T--------------------T----o-----|-------------------------------|----------------X------------X---------|---o---------|-----o-----------------o----o------------f---
----o-------------------------------|--|-----o--------------|----------|----------------------oX----Xo-|----------------o----------------------|-------------|------------------------X----------------f---
m-----------------------------------|--|--------E-----------|----------|---------------------E---------|---------------E-----------------------|-------------|--E--------------------------------------X---
XXXXXXXXXXXXXXXXXXXXXXXXXXXXXXXXXXXXXXXXXXXXXXXXXXXXXXXXXXXXXXXXXXXXXXXXXXXXXXXXXXXXXXXXXXXXXXXXXXXXXXXXXXXXXXXXXXXXXXXXXXXXXXXXXXXXXXXXXXXXXXXXXXXXXXXXXXXXXXXXXXXXXXXXXXXXXXXXXXXXXXXXXXXXXXXXXXXXXXXXXXX
