-----------------------------------------------------------------------------------------------------------------------------------------------------------------------------------------------------------
-----------------------------------------------------o-----------------------------------------------------------------------------------------------------------------------------------------------------
------------------------------o----------------------------------------------------------------------------------------------------------------------------------------------------------------------------
---------------------------------------------------------o-------------------------------------------------------------------------------------------------------------------------------------------------
--------------------------------------------------o---------------------------------------------------------------------------------------------------------------------------------X------o---------------
-o---------o-----------------------------X-----------------------------------------------------------------------------------------------------------------------------------------------------------------
----------------------------------------------------------------------------?--------------X--------------------X------------------------------------------------------------------------------------------
------------------------------------------------------------------------------------X------------------------------------------------------------------------------------------------------------------v---
------?------X--------------------------o--------------------XXXXX?XX------------------------------------X------------------X-------------------------o------------------------------------------------f---
-------------------------o----------XXBXX?XX-----------------------???-----------------------------------------------------?????---------------------?-?---------X-------------------------------------f---
------------------------------------XXX----------------------------------XXXXXX--------------------------------------------------o--------XXXXXXX----------------------------------------------------o-f---
-X------------------------------------------------------------------XBXXXX--------------------------T------------XXXX------------------------o--------o-------------XXX-----------------------o--------f---
-----------------------------------------------------------XXXXXXX----------------------------------|---------------------------------------------------------------XXX----B---------------------------f---
--------------------------------XXXX----------------X-XXXXBXX---------------------------------------|--------------------------------o------------------------------XXX--------------------------------f---
m----------------------------------------------o----------------------------------------------------|------------------------E----------------------------------------------------------------E----E---X---
XXXXXXXXXXXXXXXXXXXXXXXXXXXXXXXXXXXXXXXXXXXXXXXXXXXXXXXXXXXXXXXXXXXXXXXXXXXXXXXXXXXXXXXXXXXXXXXXXXXXXXXXXXXXXXXXXXXXXXXXXXXXXXXXXXXXXXXXXXXXXXXXXXXXXXXXXXXXXXXXXXXXXXXXXXXXXXXXXXXXXXXXXXXXXXXXXXXXXXXXXXX
