-----------------------------------------------------------------------------------------------------------------------------------------------------------------------------------------------------------
-----------------------------------------------------------------------------------------------------------------------------------------------------------------------------------------------------------
-----------------------------------------------------------------------------------------------------------------------------------------------------------------------------------------------------------
-----------------------------------------------------------------------------------------------------------------------------------------------------------------------------------------------------------
-----------------------------------------------------------------------------------------------------------------------------------------------------------------------------------------------------------
-----------------------------------------------------------------------------------------------------------------------------------------------------------------------------------------------------------
-----------------------------------------------------------------------------------------------------------------------------------------------------------------------------------------------------------
------------------------------------------------------------------------------------XXXXX--------------------------------------------------------------------------------------------------------------v---
-------------------------------------------------------------------------------------------------------------------------------------------------------------------------------------------------------f---
-------------------------------------------------------------------------------------------------------------------------------------------------------------------------------------------------------f---
-------------------------------------------------------------------------------------------------------------------T-----------------------------------------------------------------------------------f---
-----------------o----------------XXX----??????------XXXXXXXX----XXXXX---XXX-------XXXXXXXX---------------????????-|---------XXXXXXX------------------XXXXX--------------------------------------------f---
-------------------------------------------------------------------------------------------------------------------|-----------------------------------------------------------------------------------f---
--------------------------------------------------------------------------------------------------o----------------|-----------------------------------------------------------------------------------f---
m------------------E------------------------------------------------o--------------E-------------------------------|-----------------------------------------------------------------------------------X---
XXXXXXXXXXXXXXXXXXXXXXXXXXXXXXXXXXXXXXXXXXXXXXXXXXXXXXXXXXXXXXXXXXXXXXXXXXXXXXXXXXXXXXXXXXXXXXXXXXXXXXXXXXXXXXXXXXXXXXXXXXXXXXXXXXXXXXXXXXXXXXXXXXXXXXXXXXXXXXXXXXXXXXXXXXXXXXXXXXXXXXXXXXXXXXXXXXXXXXXXXXX
