-----------------------------------------------------------------------------------------------------------------------------------------------------------------------------------------------------------
-----------o--------------------------------------------------------------------------o---------------------------X----------------------------------------------------------------------------------------
------------o----------------------------------------------------------------------------------------------------------------------------o-----------------------------------------------------------------
-------------------------------------------------------------------------------------------------------X---------------------------------------------------------------------------------------------------
-----------------------------------------------------------------------------------------------------------------------------------------------------------------------------------------------------------
---------------o---------------------------------B-----------------------------------------------------------------------------------------------------o---------------------------------------------------
-------------------------------------------------------B----------------------------------------------------------o------------------------------------------------------------X---------------------------
-----------------------------------------------------------------o-----------------------------------------------------------------------------------o-----X-------------------------------------------v---
-----------------------------XXXX------------------------------------XXX----X-----------------------------------------------------------------???????--------------------------------------------------f---
-----------------------------------------------o----?-------XXX----------XXX-----------------o-------------B---------------------------------o------------------------o--------------------------------f---
-----------------------E-------------------------------------o-------------E------------------------------------------------------------------------------------o--------------------------------------f---
---------------------BXXXXX--XXXXXXX-----o------------------XBXXXXXXXXXXXXXX--------XXXX--------XXXXXBXXXXX-XXXXX-------X-??????------TXXXXX--XXX---XXXX---BXXXXX--------------------------o-----------f---
------------------------------------oo------------------------------------------------------------------------------------------------|-T-----------------------------o--------------------------------f---
--------------------------------------------------------------------------------------------------------------------------------------|-|-----------------------------------------------------B--------f---
m------------------------E--------------------------------------------------------------------------------E---------------------------|-|---E--------E-------------------------------------------------X---
XXXXXXXXXXXXXXXXXXXXXXXXXXXXXXXXXXXXXXXXXXXXXXXXXXXXXXXXXXXXXXXXXXXXXXXXXXXXXXXXXXXXXXXXXXXXXXXXXXXXXXXXXXXXXXXXXXXXXXXXXXXXXXXXXXXXXXXXXXXXXXXXXXXXXXXXXXXXXXXXXXXXXXXXXXXXXXXXXXXXXXXXXXXXXXXXXXXXXXXXXXX
