-B--B-X-BXo--B----------?--------------------X--ET-|--?--B---X----M-----X-----|-BM-T--?-?-EX-o----Xo-EE--T----------E-----T-X-EX-------|-------?-o-----M-M------?----B---------E----EM-M-B?-----|--|T-|-
-o------o--M--|X---------BETX---------|-o-?-----M--|B------XXE-|--?---------------o-M--Xo-----M|----T--------------T-----------?-----o--------------------M---?---o----M--|--T-------M--|T?---M--X---?o-
------X---T---E--------BT-MXE---|--X-X--E-B--?------------------|-----E--E---B|-T---M-M--T---M---M---------B---E-----MX--------|----?-X--------------------------o??T------------M--?--------X----------
----?--M--o--|?-?-X-----oE-Bo?B-----o------E----------------E----o----|---------?-M------------X---E------XE-T-BE----T----B-----------B--T-----?-----T?-------Eo---BX-------|-M--|---T------o---E--|B---
-M---T---B--o--------?---M---B--o---MMB---?--E------------|---B------T------M-----E----|-B--M-------To--o-E---o---BXX?-----------oE-------B---B------------o-X-B---------M----Eo--B--------BM---X-B--|--
--|E-X--o-E-|------M-----E---EB-------T------X----------------E---M---M---M------X---E--------------X-T|-----?-??-XM---M---------?---?T--M---B-M---T-----?-|o-----------------XB-o----X--B|---B--T-oM---
--X-?X--X--X---X--MM-------------B-E-----X------?|---B-B----X-E-----------X-?---B--o--?M----E-----?--o---o--M---o-----?---M-M-E------B--o--B-|---X-------B-T|B---o-------------|---X-X---?-----------|--
----M---B-------------o-------M----M----M---EE-------M---M--T----B--ET-B-BX-T--------EE---E--T----------o--E----X--|-M---------------------------------?---T-------M--Xo-----E-----XE-----E-B----?---|Tv
--X-E--------T-----M-------|---EX----o----ToX?---E-X-----B-----EB?-o-------|B---X|--X---E----E-----E------------------o------------------E---|--XX-E----X|--o?---B------E----||-?E-----MX-----------E?-f
-----------------E--M--X-|--|----------|-B--Bo--------------|?-------o---E-T------------M---B-B--|X--?----?--Bo--------|E--E--oB--T----------EM-B--?--ET--oB?------E-----------|---|--BEE--|----TX-X-|-f
---T-------X---M--E-----|-----EM------|--B-o---------X------E------T-----------M-----o|----B--------|-?------------?----X-?--o----o------|?--------EM------------X-?E---TTo--------?-BE-?-?---X---E--Tof
----M-?--------|--T-X-----------E---B-?--T-----------o-------------B-------E---------|----------------B--M----|-X---------T--|---T----T--------------BT-----E?MM---B--------EE------X---o-------||--E-Bf
--|o---T---------o----?------X---B-X--------o-------o-----o----?-------T---------X--oM-|---------Xo-E--X-T---T-----E--T?-E---------||-|-------|-|-T-----B-----B-E-M-T-T-M---|----|--?---X--?M?-|---?E--f
-------E-------|M-B---B-----------o---XoB------E-------T---oo----------------?B----T--?-B-XX-E--------?-------o----------|--------To|-------|----X----X-?----X----M--oE-|--o--------------|?M-|--X-T--Ef
m--X---T-X-------o----B----M----TX------M--M--E-M---------M-X-----?-M------?|TX-------T---X-M---E--------|-T-----|-B----------BB--B-|--M|---------M---|-----E-?---B----------------M---------X-E-------X
XXXXXXXXXXXXXXXXXXXXXXXXXXXXXX?XXXXXXXXXXXXXXXXXXXXXXXXXXXXXXXXXXXXXXXXXXXXXXXXXXXXXXXXXXXXXXMXXXXXXXXXXXXXXXXXXXXXXXXXXXXXXXXXXXXXXMXXXXXXXXXXXXXXXXXXXXXXXXXXXXXXXXXXXXXXXXXXXXXXXXXXXXXXXXXXXXXXXXXXX
