-----------------------------------------------------------------------------------------------------------------------------------------------------------------------------------------------------------
-------------------------------------?--------------------------o-----------------------------------------------------------o-------------------------------------------------------------o--o-------------
------------------------------------------------o------------------------------------------------------------------------------------------------------o----------------------------X----------------------
-------------------X---------------------------------------------------o---------------------------------------------------------------------------X-X-----------------------------------------------------
-----------------------------------------------------------------------------------------------------------------------------------------------------------------------------------------------------------
--------------------------B------------------------------------------------------------o-------------------------X----------------o------------------------------------------------------------------------
------o-----------------------------------------------------------------------------------------------------X----------------------------------------------------------------------------------------------
------B----------------------------X-------------------------------------?-------------------------------o--------------------o------------------------------------------------------------------------v---
---------------------------------------------------------------------------X------XXXX-------------XXXXXXXX----------T------------------XXXXXX--------------------------------B------------------------f---
---------------------------X----XXX---XXXXX--XX-XX-----------------------------------------------------------------XX|X--------------------------------------------------------------------------------f---
-----------o--------------?---------------------------o------------------o-------------------------------------------|-XXXX---BBBBBBXX-Bo------------------------------------------------X-------------f---
---------------------------------------------------------XXXXXXXX----------------------------------o-----------------|--------------------------------XX---------------------------------------o--o----f---
--------o-------------------------------------XXX------------------------------------------------------------------XX|XXX---------------------o------------BBBBB------------X------o-------------------f---
---------------------------XXXXXXXX---XXXXX--------------------------------------------------------------------------|------------------------------------------------------------------?--------------f---
m-E------------------------------------------------------------------------------------------------------------------|E-------------------------E---o------------------------------------------------E-X---
XXXXXXXXXXXXXXXXXXXXXXXXXXXXXXXXXXXXXXXXXXXXXXXXXXXXXXXXXXXXXXXXXXXXXXXXXXXXXXXXXXXXXXXXXXXXXXXXXXXXXXXXXXXXXXXXXXXXXXXXXXXXXXXXXXXXXXXXXXXXXXXXXXXXXXXXXXXXXXXXXXXXXXXXXXXXXXXXXXXXXXXXXXXXXXXXXXXXXXXXXXX
