-----------------------------------------------------------------------------------------------------------------------------------------------------------------------------------------------------------
----------------------------------------------------------------------------------------X--------------------------------------------------o----------------o---------------------o------------------------
------------------------------------------------------o-------------------------------------------------------------------------------oXXXXX---------------------------------------------------------------
-----------------------------------------------------------------------------------------o-------o--------------------------------------o------------------------------------------o-----------------------
--o-------------------------?-------------B--------------------------------o------------------????------------------------------B--------------------------------------------------------------------------
----------------------------------------------------------------------X---------------------------------X--------------------------------------------------------------------------------------------------
-------o-------------------------------------------------------------------------o--------------------------------------------------BBBBBBBB---------------------------------------------------------------
----------X--B-------------------BBB-------------BBB--------------------------o-B------------BBBXBB------------------BBBB------------------------------------------------------------------------------v---
-----------X------------------------------------T------------------------------------------------------------------------------------------o-----------o-----------------------------------------------f---
--------------------X---------------------------|o-------------------------XXXXXXX?-----o-------------------------------------------??????------------------------o------------------------------------f---
------------------------------------------------|---------------------------------T-----------o---------------E--------------------------------------------T------------------------------------------Bf---
---------------B---BB-B--T-------XXXX---------BB|B--BBB--BBB-------XXX----BBX-----|---BBBB--XXXXXXB---TBBBXBBXB--BBBXBBBB----??B?????------------------XX--|------BBBBBBB-------------X----------o-----f---
-------------------------|----------------------|o--T-------------T---------------|-------------------|----------------------------------------------------|--------------------------------o----------f---
-------------------------|----------------------|---|-------------|----------o----|---o---------------|----------------------------------------------------|-------------------------------------------f---
m---------E--------------|-------E--------------|---|---E---------|---------------|-------E-----------|----------------------------------o-----------------|------E---------E----------E---------------X---
XXXXXXXXXXXXXXXXXXXXXXXXXXXXXXXXXXXXXXXXXXXXXXXXXXXXXXXXXXXXXXXXXXXXXXXXXXXXXXXXXXXXXXXXXXXXXXXXXXXXXXXXXXXXXXXXXXXXXXXXXXXXXXXXXXXXXXXXXXXXXXXXXXXXXXXXXXXXXXXXXXXXXXXXXXXXXXXXXXXXXXXXXXXXXXXXXXXXXXXXXXX
