--------------------------------------------------------------------------------------------------------------------------------------------------------------------------------------------------------------
----------------------------------------------------------o------------------------------------o-------------------------------------------------------------------------o-----------o------------------------
-----------X-X-------------------------------------------------o-----------------------------------o------------------------------o---X--------o--------------------------------------------------------------
------------------------------------o----------------------B-----------X--------------------------------o---------X-------------------------------------B----o--X---------------------------------------------
---o--------o-----------------------------------X-----------------X-----------------------------------o------------------------B---------------------------------------------------------------------o--------
------------------------------------------o---------B-----------------------------------?------------------------------------------------------------------------------B------X---------o---------------------
--------o-o--B-----------------------------------------------------------------------------o---o------------------------?----------------------------------------------------------?--------------------------
-----o-----------o-B----------------X--------------o----X------------------------------------X----------o-------------------------------------------------X-------------------------------------o------v------
-------------------------------------------------------------X------?------------X---------------------?-------------------------------------------------------------------X---------------------------f------
------------------X-------------------------------X------------------------------------X----------------------------------------------------B-o------X-------?-----------o-----------------------------f------
-----------------------------X-------------------------------------o---------?----o-----------------------------------X-----o-------------------o---------------------X--------------X----o------------f------
---o-----------------X-----------------------------------------?---------------------X---o----------o---------------------------------------o------------T--------------?-----o----------B-------------f------
-----------------------------------------o----o------------------------o-T----------------------o---------------T-----o-----------------o----------------|---------------------X-----------------------f------
--------o-------------------o----X-------------------------X-------------|-----------X---------------o-------o--|----------------------------------------|--------------------B------------------------f------
m-----------------------------E----E-------------------------------------|------------E-------------------------|----------------------------------------|---------------------------------E-----------X------
XXXXXXXXXXXXXXXXXXXXXXXXXXXXXXXXXXXXXXXXXXXXXXXXXXXXXXXXXXXXXXXXXXXXXXXXXXXXXXXXXXXXXXXXXXXXXXXXXXXXXXXXXXXXXXXXXXXXXXXXXXXXXXXXXXXXXXXXXXXXXXXXXXXXXXXXXXXXXXXXXXXXXXXXXXXXXXXXXXXXXXXXXXXXXXXXXXXXXXXXXXXXXX
