--------B---------E-?XEX-B----?---XT-----T----o------------T--o----T---M--o?----Bo--------o-------|------X-M----------?----------T-------|--M--BB--o--------?T-------B--------------E--E-X-?--B---------
---M------o--o-------BTo--M-?-X--T---X----E-X---ooo-?----o--|--B---------B-B-----M--B----?-------|---|-----------B-o-T-------T---------E----E----|-E---?------ETT|E------?T--------?---E---M?-----TX----
------X----T|-T---E-B-MB-----EX?-----------E---X-E----X-|?-o--o----o----o-E--E-------E---|-------------T-------XEB-o---E-E----B----?-M----o--------?-----X-----|--------------|-----T?------------B-----
-Bo-------X---E|-|----XT-|-T-T-----o-T--?--M-------X|-XX--M----TX---E-M-----oB----E--BM------------o-X----B-----------oX--B--oX------M?-----B------|-----oT-o-------X-T-X--------X-------M----M----X?---
------M-?-B-E---|-------------EBT-T------?----------ET-TE--?B---------T-------------X-X-----------------?-----|o-?--E-B--B---|-M-T--X|---ME----X|----------E-----?------?---|-B---|?|---o--BM------o-T--
----E-|-----M--T-------?----------E--B-----?-------M------?----------?-------o--X-X|-o----B-E------------------?-B?--X|-----E--E-M-M-oT--o-----|---B-EB-------|----M-o-MM--------?----------B-----------
------M------------XX--B-B-------X-M--ooB----M---------M------B-----------?o------------?--B-?Boo-EE---X--B--?--T---X--|?-B--o-B--X|------o---------------E---?---T------X---TB--------B----T--M-o--E---
-----E--EM-?-------M--X----------MM-----------E--E--X------M--X----|--B-|------oB-|B-XM--X----M--------?--|o-----B------?M--ME---o-o-?----------TX-----T-||-E------M-----?---------|-?--------?X-M-B---v
-X----?-T----T--o?----T----B----o--------?--ME-----------T------X--------o--------EB--B---------T-----------BX-----?--MM------------|-----|--------BB---|---B--T-?o|-------M-?B-X----|-B-------------M|f
-M-------------------?-?------------E-----------?----------o----oB|--|--?------E--------X---M--?--|-----------M-------|B??--Eo-ET---MM-B-?|--M-------X---o-T?--------|--XBo-E-B---------------?---?--X-f
--oT-----|-XM-?-|XX-----------------E-X-B-M---X--E----X----|--E--------------BB---M|-?MT-----X-----o---|T--E-E----T--------E--X|--?---T|------X?-----------XT---|-----X?---T-----E-----------------?---f
--?----o--------E-----B--o-o------o--oo---------X----------X--o---MTE-T-M----|-|EM--?------T--------M--------|To----TEB------TBT--B--T-M-|-?---o----B-?-|BM-----XT|-------XTB-?-o---M---------------T?-f
-E---M------------M-----o--B---E|--------------M-EM--B-----------T--------X-----------E--EBT--X-XoM--XB---BM--------------B--E---T--Mo?------TB----M----------T?-M----------T-----XT-----X--M-----|B-M-f
---X------?--T--E-|------------?TTXo-----------------X-------Too-T---X---o------M---EE------------M---B-----?-E?-------||--E-X-----|-----?----|------X?-----B-----------TEoB-M------M-----------T??o---f
mBB-T----B---------B-------E-------------T----M---|-X--T-------------E------------|----------M---?--B---------E--------X-MMX-E-?--E---------T----X---------|E-----------X------B-------o-|-EM---M----B-X
XXXXXXXXXXXXXXXXXXXXXXXXXXXXXXXXXXXXXXXXXXXXXXXXXXXXXXXXXXXXXXXXXXXXXXXXXXXXXXXXXXXXXXXXXXXXXXXXXXXXXXXXXXXXXXXXXXXXXXXXXXXXXXXXXXXXXXXXXXXXXXXXXXXXXXXXXXXXXXXXXXXXXXXXXXXXXXXXXXXXXXXXXXXXXXXXXXXXXXXX
