-----------------------------------------------------------------------------------------------------------------------------------------------------------------------------------------------------------
---------------------o-----------------o-----?-------X--------------------------------------------------------------------------X-----------------------o--------------------------------o-----------------
---------------------------------------------X------------X--------------------------------------------------o-------B----------------------------o---------------------------------X----------------------
-------o------------------------------------o--------------------------------------------------------?-----------------o----------------------------X--------------------------------o----------o----------
-------------?--------X-----------------------------------------o------------------------------------------------------------------------------------------------------------------------------------------
---------?--o-----------------------------------------------o----------------B----------o----------------------BBBB-------------------------o----------------------------------------X---------------------
--------------------------------------o-----------------------------------------------------------------o------------------------------------B-o--------------------------o---X----------------------------
----------------------o--------o-o-----------------------BBBBBXBB----------------------BBBBB------------------------------------BBBBXB-----------BBB--------------------X-----------------------B------v---
----------------------------------------------------------------------------BBB--------------o-T--------------BBBB?-----T-------------------o---o-------------------------?----------------------------f---
-----X---------------------------------------B-------------BBBBBB------------------------------|-------o---BBB----------|-----------------------------------------o------------------------------------f---
-------------o-------------T-------T-----------------------------------------------------------|------------------------|------------------------------------------------------------------------------f---
---------------------------|--T----|------------XBBBBBBBBXBBBXBB-------XXXXB---------BBB----B?X|X-X?X??--???????---B?BBB|BB-BXBBB?B---BBB------BB?BBBXB--o----?-????---------------------------o-------f---
---------?-----o-----T-----|--|----|-------o--------------------------------------------T------|------------------------|-----------------------o---------o-o------------------------------------------f---
---------------------|-----|o-|----|------------------o---------------------------------|------|------------B-----------|----------------------------------o-----------------------------------------o-f---
m--------------------|--E--|--|----|----------------------------------------------------|------|------------------------|--------------E-------------E--------------------------------E------------E---X---
XXXXXXXXXXXXXXXXXXXXXXXXXXXXXXXXXXXXXXXXXXXXXXXXXXXXXXXXXXXXXXXXXXXXXXXXXXXXXXXXXXXXXXXXXXXXXXXXXXXXXXXXXXXXXXXXXXXXXXXXXXXXXXXXXXXXXXXXXXXXXXXXXXXXXXXXXXXXXXXXXXXXXXXXXXXXXXXXXXXXXXXXXXXXXXXXXXXXXXXXXXX
