--M--|-------------To-Mo--BB-EM----B------B-MX--o-|---oE--?-T----T-----------M-----BM---M-----|-----B----------?-T--?T--------T-|--M-X-----XoM-B-----To---B?-E--E-B---T-----X------?--E------T-|-|--|Eo-
-M-T-T-o------------|--------------X--T?----------T?--B-?T-------X---o?---|-M--X-o-----?--E------E--o--BM-B--o--------B----------E---X-TBBoE---------------o-T-M--BX-X-----EBX|-M------o--|?----------M-
-E---M--E-?--?M-------|--?BoT-|o---B----?--X-------E------XX----------------?-----?----E------E---T---B-M---oE---E----MM-B--o-E||--T-----|--B---M-------------E--?-M--XM-|-----B---E-oX------------|-T--
---?X-EM-----?--------M-------?-------XE?-------|-B--oB----B-BX-----B---M---X---o|E-----TE-------T---MBX-------EE?---E-|--M?-------|--o?----?-----o-----E--|---|X------E-------------------o-----M-X----
-------------X----E---|--XT---XE--?B--E-B---?X-?----------------X---------T--M--X--XMT-B-E---BX-----?-?----|X-----------M-------BB---o----B|---M------T--------------M--o--------------------??o--E-----
---------M---o-------------E|-----X-MX-|E---------o------B-----o--?-------?-?-------TX---BXo------EM----M--------|--|-?---------M--XX----B---E--------------B-B---------o-BX-----E---------T----B--?M---
----|-----?------?------|T---o-----E-T-------T-----B-X-X-----E?--||-T-B---Eo---B-?--------M-------o----B-------------B---o?-E----X-----M----?-B--o--|T---?--|----?T-------X-------MT----?M-------EXo?---
--|T-|-M---Mo-----|--o-------X------?---?M-?-----|-----|XB|----?T----EE----X---o----------------------?---------|--------BB--|---E-o-------E---Eo-M-----o|-------------o-----X-------E------B-E-E------v
---?-----E--?-----|TT--|--MXMM---?o??-----|-----T--|T---B-------ET----------T-?--X---M--|-|M--oT--------------X--X--o-MX-------X--|-X-T-----T-|-|---o-M--------||---|-M----MB-----|-X--T--E|?-?|-|Mo?--f
--|--|?--?---E--T--------------o---------o----T---?----------o--o------------X--E----BM|--T--o----------------TB|-----o?--o------------TB-E---E---o----?--o-------|--X|-------?T|---M-----?----B-T-?---f
---E----|---|-B----M-----E----E--T--------M-----X----T-TB----------X--o--B------M-|XE---?M---------?--oMT---------X----------E?T----B-|-------------T-|-------------E----------E----B-M--?----o--------f
-----------|-----E---T--------o-X-T-T-M---B--M?|-T|B------B--o-----XTT|E-----M--?---X----|X--------T-----|------T-------E------X---------?---------?------T-M----MT-------B-?------------BT-XB---------f
-X-B--o----E--X----M--B--X----------M-X-T?-----T--X----X--E---E-------------?E---M---X----------T-----------B-----B---oBo-X-B-----X----------------X----o-X-oB--------T------X-------------oEB----M-M--f
----E-M-----|-------B-M-E-----?--T--T-B-?----X?---E-------|o---TEEo----?E-----MB-----|??-------o-ooE------X----T---X-----o----------T-----o-------?-----X---T-?------------?|----X----|-T-T-------M----f
m-M--?--X-o|-----X-----B---o-T----o------------?-----------------T-------XT-------Xo---M-----|------M--|--MXXXB---M|-E-----MoE------|-?---B---------------X--------------E-------------B-M--|--------MBX
XXXXXXXXXXXXXXXXXXXXXXXXXXXXXXXXXXXXXXXXXXXXXXXXXXXXXXXXXXXXXXXXXXXXXXXXXXXXXXXXXXXXXXXXXXXXXXXXXXXXXXXXXXXXXXXXXXXXXXXXXXXXXXXXXXXXXXXXXXXXXXXXXXXXXXXXXXXXXXXXXXXXXXXXXXXXXXXXXXXXXXXXXXXXXXXXXXXXXXXX
