-----------------------------------------------------------------------------------------------------------------------------------------------------------------------------------------------------------
-----------------------------------------------------------------------------------------------------------------------------------------------------------------------------------------------------------
---------------------------------------------------o--------------------------------------------------------------?------------------------------------?------------X--------------------------------------
-------------------Bo--------------------------------------B--------------------------o-------------------------------------------------------------------X------------------------------------------------
-------------------------------------------------------------------------------------------o-----------------o---------------------------o-------------------------------------------------------?---------
--------------------------------------------o-----------X-------X--------------------------------------------------------------------------------------------B---------------------------------------------
-----------------------------------------------------------------------------------------------------------------------------------------------------------------------------------------------------------
-----------------------------------------------------------------------------------------------------------------------------B-------------------------------------B-----------------------------------v---
--------------------XX--------BB--------------XXXX-X--------------------o---------o----------------o----------------------------------------o--------------------------------------------------o-------f---
-------------------------------T--------------------------XXXXXXB------T----------------XXXXXXXX----------------------BXXX-----------------------XXXXX-------------------------------------------------f---
------------------------------X|---T--------------------------o--------|------------o-------------------------?---------------------XXXXXX-XXX----------BBBBB------------------------------------------f---
------------------------------X|X--|-----------------------------------|--------------------------------------------o----------------------------------------------------------------------------------f---
-------o-----------------BT----|---|-----------------------------------|----------------------------XXXX------------------------------------------------T-----------------------------------------o----f---
--------------------------|XXX-|---|---------------?---------XXXX------|-----------------------XXXX-?---------XXXXXXXX--------XXXXXX--------------------|-------------------------------------?--------f---
m-----E---E---------------|----|---|-----------------------------------|------E--E----------------------------------------------------------------------|----------------------------------------------X---
XXXXXXXXXXXXXXXXXXXXXXXXXXXXXXXXXXXXXXXXXXXXXXXXXXXXXXXXXXXXXXXXXXXXXXXXXXXXXXXXXXXXXXXXXXXXXXXXXXXXXXXXXXXXXXXXXXXXXXXXXXXXXXXXXXXXXXXXXXXXXXXXXXXXXXXXXXXXXXXXXXXXXXXXXXXXXXXXXXXXXXXXXXXXXXXXXXXXXXXXXXX
