-----------------------------------------------------------------------------------------------------------------------------------------------------------------------------------------------------------
----------------------------------------------------------o------------------------------------------------------------------------------------------------------------------------------------------------
--------------------------------------------------------------------------------------------------------------------------------------o--------------------------------------------------------------------
------------------------------------------------------------------------------------------------------B-------------o----------------o---------------------------------------------------------------------
-----------------------------------------------------------------------------------------------------------------------------------------------------------------------------------------------------------
-------------------------------------------------------------------------------------------------o------------------------------------X--------------------------------------------------------------------
----------------------------------------------------------------------------------------------------------------------X----------------------------o-------------------------------------------------------
----------------------------X---------------------------------------------------------------------------------------------X----------------------------------------------------------------------------v---
-----------------------------------------------------------------------XXXXTXXX---------X---------------------------------------------------BXXXXXXX---------------------------------------------------f---
---------------------------------------------------------------------------|-------o-------------------------------------------------------------------------------------------------------------------f---
---------------------------------------?-----------------------------------|XXXX---XXXX--XX----?--XXX-----------XBXX-----------------------------------------------------------------------------------f---
---------------------o--------X--------------------------o--------XXXXXXXX-|---------------------------------------------------------------------------------------------------------------------------f---
---------------------------------------------------------XXXX--------------|-------------??????---------------------------???----T---------XXX-----------XXXXXo----------------------------------------f---
------------------------------------------------------o------------o-------|-----------------------------------------------------|---------------------------------------------------------------------f---
m---E---------------------------------------------------E------------------|-----------------------------------------------------|-----------------E-------------------------------E-------------------X---
XXXXXXXXXXXXXXXXXXXXXXXXXXXXXXXXXXXXXXXXXXXXXXXXXXXXXXXXXXXXXXXXXXXXXXXXXXXXXXXXXXXXXXXXXXXXXXXXXXXXXXXXXXXXXXXXXXXXXXXXXXXXXXXXXXXXXXXXXXXXXXXXXXXXXXXXXXXXXXXXXXXXXXXXXXXXXXXXXXXXXXXXXXXXXXXXXXXXXXXXXXX

