-----------------T--o-XE?----T--?-?T--B-E--E-M---?---E-------o-T----B----?|-XE----TX----X-----------------B---B-----E-?-?-o|-|--o-----------o-T--?--------o----B------M-M------------E------|-E-----??--
--oM--------X------T-?------M--?--o---------Eo-o-E----E-------B--T|--M--TE---------X-?M?MMoT---------B---o?--Bo---?MM-MX-o--------BM-T--E?----o-------------|X--------------M--o----B---|------B--------
-E--EE----?-X-o-|o----TX-------ET--------B--M---B----------M-----?--------T--o--------X-X-B-----------B-TE-----|-E-------------|-----T-T----------------?-----?---------?----------T----|-B-------------
---B-M--X-o---T-BM------oM---T-----?o------X-------------E-BE-M?-----TX-?---------T---XX---------o---o--------o---B-------M--------|---E---E--E--------|-BET------E-------?---o---M--?Xo---?----E-|-B---
-------------MoE------B---o--X---T-MM-------------------B-----M--------------TX--E------X--?--To-----T---E-M-X----------B--MB---o------?---E|---o--EB-----B-?M--X--ME-o-----------M---X-------------o---
----X-oX-o-X-----TM----M--E-|-------|------------MX-----B-----?-E--?---M----?-----|------X-------T-|----|X--------|-----E--?-Xo---B---TE--------------T---|-M-------o-oT--E-X--MX----?XXoo---?|--?-E----
-X---B--------X----T------------X-?---o--|---------------BT-T-X-------M-----?--|-o-B-------T--------M--o-M-X-----TM--|B----------?-o-----?XBX-??----T---E------??----o----------X-----TX-E-X-oB--B------
----E--E-|----XT--|Mo|--TXoXE?------o--M--o--M---B--------------M------?-|ME--E--------X-|----|--?--X-B---?---------T-X|--TT--B?---T--Xo---------MXT---MX?---o-------|----|E-----M----E-|------T-E--XBov
-|-----E------E-------E--MM--o-TE---T-?----------B---------BX--oBBX--X---------X------M---T--?-----o-M------o-------MM--TX-M-E---------o------T|-----E--B?----o-|-----M-----M|---|-----------------T|-?f
-T-X------BB----?------------------------T|---T-----------Mo------------M----------o---T?----------|---T---T-----------o------BX---------B-B-----o-T-X-------T-------------oE----?----------?o--B--BB--f
-M---|X|--E-ET-B-To----|--------TT-T----B--XX------o-B?----B----X-----o-X---------------E--T--------B--T----B----B---|--M---------M----?--TT-----------oEo|----B------X--------M---?----E--B-XT-------Bf
--E---?----------o--E---M-o---M------------------?-o---?---------T--|---M------T-B---------|o------Xo|X--?----T-|-----B----E----E---X------------?---|--|-----E---E---E-----T----?-------B-----o------of
-------B--|--B|o-X---?-------X-X---------?---X-B---T-----T----M---XM-E----X---||---T-------o----T--M?-----o-----------T----------?--XE---B-T--X------------B-?----T----------XX-----|---------|--o--o--f
---------E---X?----------Eo--M--o-|-?-----E------?---oB---|E---XT?T-------B---|------T|---------Xo-?--o||---o--------M--BXE-BB--B-|---------T--------------M------B-o|-T--------B----E--o-|--------T---f
m------B---M---oE-X-B-------T---X-|---?--E----?-oT---o?---------|-------B---MM---T----------T-X----|--E-X--------------E---E-----X-?----TM-------M|------B--B-?-B--E------------?----M--ET-oT----------X
XXXXXXXXXXXXXXXXXXXXXXXXXXXXXXXXXXXXXXXXXXXXXXXXXXXXXXXXXXXXXXXXXXXXXXXXXXXXXXXXXXXXXXXXXXXXXXXXXXXXXXXXXXXXXXXXXXXXXXXXXXXXXXXXXXXXXXXXXXXXXXXXXXXXXXXXXXXXXXXXXXXXXXXXXXXXXXXXXXXXXXXXXXXXXXXXXXXXXXXX
