-----------------------------------------------------------------------------------------------------------------------------------------------------------------------------------------------------------
-------------B-------------------------------o----------------o-----------------X--------------------------------o----------oX----------------------------------------------------o---------------oo-------
----o---o--------------o--------o------------------X-------------------------o-----------------------------------------------------X----------o---------------------------------------------o--------------
----------o------------------------------------------------------------------------------------------------------------------------------------------------------------------------------------------------
----------------------------o---o----------o----X----------------------------------------------------------------------------X---------------------------------------------o--------o----------------------
----------------------------X-----------X----------------------------o--X-BBBX--------------------BBBBBBBB----------------------------o-X----------------????---------------?-------X----------------------
------o-o--------------------------o----------------o---------------------------------o-------o----------------------------------o-------------X-----------------------X-----------o-----------------------
--X-------------------B-------?--------------------------------------------XXXX---XBBBXBB---------BBBBBB---------------------------------------------B?-BBBB---------------------------------o-o-------v---
---------------o-?---o-----------o--------------o-----------B----T---------------T------------------------------------BBXB--------------------------------------B--------------------------------------f---
----------------------------------------T------------------------|--BBBBBBB------|----------T----------------------------o---------?------------------------------------------------X------------------f---
-------X-----------------?B-------------|------------------T-o---|--------o------|---------E|--------------------X------------------T--------T?--o-----------o-----------------------B-X--------X----o-f---
--------------------XBB--------XBBB-XXBB|-----X--------BB--|---??|--BBXBBBXB---BB|XB?-BBBBBB|-----BBBB-------XXX-XXXXX-o------------|-o----T-|-???XXX??---BBBBBB----------o-------------------X-o------f---
---------------------------o------------|------------------|-T---|-o-------------|----o-----T---------------------------------------|------|-|-------------------------------X---B---------------------f---
----------------------------------o-----|------------------|-|---|---------------|----------|---------------------------------------|------|-|-------------------------------------------o-----------o-f---
m----------------------------------E----|------------------|-|---|---------------|----------|---E-----------------------------------|------|-|------------------------------------------------E--------X---
XXXXXXXXXXXXXXXXXXXXXXXXXXXXXXXXXXXXXXXXXXXXXXXXXXXXXXXXXXXXXXXXXXXXXXXXXXXXXXXXXXXXXXXXXXXXXXXXXXXXXXXXXXXXXXXXXXXXXXXXXXXXXXXXXXXXXXXXXXXXXXXXXXXXXXXXXXXXXXXXXXXXXXXXXXXXXXXXXXXXXXXXXXXXXXXXXXXXXXXXXXX
