--------------|-T--E----E-o-T-------X-----T-M--TX-?B-----X--|---??T-----o---T--E-----o--E-------?--XT-X-------X-E-|?---o------T-M----T-B---------EX----M-o--?-|----E----M-T----T--------|---------M-----
-------o-E-?--B-E----X--------------?-----?-----E|--?-|BT-T------M--BT--o---E--|-----------B-E------------o---B-?-----T-|-E?--|-------?--E-------M------B---X-------E--TM??----T?------o-T--X-----?--X--
-------?-----o-|-T?---X-----??-E?-----X--o-----o?--E-----X--------o-----|X----------?--?----|-----B-|E--?----E--M----X--E--BX-?-TEX----TM---------EM|o-----------T-oEE--BTX--------M?---|M--M---?--TE---
-----M-T-----T|B|----------|-o---|-X-------T--X-----o?----B---E-----------MB|M-------------------------BM-----T---?---M-----?B--T--T---T------T---?M-----?T--?--X---XB---?-------M---------|------------
------E--|-MXM-XX-X--------------B--------------?o----T----T----T-----T-XE--M-----E----Xo-----|-E?---M--X-----B--X--M---?-E?---?-------M-M--------------X-?-E--X-?M----M|---B----X-M--B-BE----oXE--BM---
----XEX--X-|---M--------X----EB------T------B------TB--X-o--------------------oB-------M--?-o-o---X|-o---o----?---o-X--M---T?----T----X---o-o--o---o----X-?---------X-------MT|B---?T----|-B----M-------
-?|T-M-||----X--o-T?-----M----|--T----X----B--o?o?------?-M-TTXE-E--------E------------------------M---o---T---X---T-------M-E|o--B------M-?-o-T-M|---o-TEo-B----o--B--B---B?--o--XBB---------X---E-B---
--o---o-----B---------?E?---?o-TB---M-------E-?--MT-T-----o---|-----oX-T--------------M-?------E-------B------------E---?-?---|--o--TT---T--|--o-|---T?-B---T---?------------------T--------o-E----B--Mv
---M-------E-----TB----E--|-B---B--M-----M--------------?T----------B---------?-?o----?|----?-----o-----o-XTE-MT--T-------------------XE-----------?--?---|-?-T-X-------o---|----T--|T-oXM--X--------E-f
---------|-----T---|--------o------------TE|------X-----------|---?B--------TM---E-----o---o-----------X---M-------X--T------o---E---?-M--o------MB-E-----X---BB----o-X-------X--E----B----------------f
------o-?B---o----E|-X---?------X------?T----|-o------o-----M-X----------?--B|-oT-------M-------o|-EB-------o-|---------M--T----T------?----E-T|--|-----B--------|-------|--B-|---X?EB-------|-----B---f
--------?X-T------XE----?E-------------X---B-M------o-E--BM----------------E--T-X---E?--B----o-MoXX-Bo-------------E-----B-T-E--X-?----E---E----M----E----M--------M----?-X-------E--------?---Eo--o---f
-M-T-----E?M-B-X---?---E-X---B--o-X--------T------o-------oB-M----|-?-----------E-----?-M---E-oE--?----EB--BBo---?B--?-E-T-E---B-------------E---------?---T---?--T------o---M?---T-?----T|T--------T-|f
-|-------B-----M-E-X-o--?---M--T-M---E-------T---------X-B---|------T-T-------E-T-B-----X-|B---|--o----M-o------M-|--M---B----------|---BB----B--M?X-------X--o---T------?-------o-X?--|------?-o--|---f
m---------o-----M-|----X----|T-?---M-T----------|-----?X-T---|--?|------M-----M----o---X|o---o-B|----------T---|M?---------------M-------?o-E-E--?M-?--o--------|-o-M--?-----M-----M-------|-oX|-MM|---X
XXXXXXXXXXXXXXXXXXXXXXXXXXXXXXXXXXXXXXXXXXXXXXXXXXXXXXXXXXXXXXXXXXXXXXXXXXXXXXXXXXXXXXXXXXXXXXXXXXXXXXXXXXXXXXXXXXXXXXXXXXXXXXXXXXXXXXXXXXXXXXXXXXXXXXXXXXXXXXXXXXXXXXXXXXXXXXXXXXXXXXXXXXXXXXXXXXXXXXXX
