-----------------------------------------------------------------------------------------------------------------------------------------------------------------------------------------------------------
---------------------o---------------------------------------------------------------------------------?---------------------------------------------------------------------------------------------------
---------------------------------------------------------------------o-------------------------------------------------------------o-----------------------------------------------------------------------
--------------------------------------------------------------?----------------------------------------------------------o--o-----------------------------------------------?------------------------------
----------------X----------o---------------B-o--------------------------------X--------------------------X----------------B-----?--------------------------------------------------------------------X-----
----------------------o-------?------X--------------?????-----------------------------------o-------------------------B-----------------X----------------------------oB--------o----o----------------------
-o------------------------------------o---o------------------X-o--------------------o-----------------------------------------------------------------------X----------------------------------------------
-----------------------------oo--------------o---------------------?--oX-------------------------------------------o---?B-BBX--------------------------------------------------------------------------v---
-----------?-----------------------o----------------------------------B---------------------------------B-------------------------------------------B----XXXXX-----?-----------------------------------f---
--------------------------------------------------XXXX----------------------------------------?----------------X-------o-----------------B-----------------------------X----X--------------------------f---
---------o---------------------------------------------------------------------------o-----o----------------------------------------------------------------------o----------------------o-------------f---
------------XX----XXXX-----------XXX------------XXX-------T-XXXX-----X?XXXXXXX--------------XBXXX--XXX----T----------BXBBXBBBXB------o----XXX---XXX---XXXXXXX-----------------------------------------of---
----------------------------------------------------------|--------o---o-?-o-----------o-X---X------------|------------------o--------------------------o-------o--------------?-----------------------f---
----------------------------------------------------------|-------------------------------------------o---|------------------o------------------?-o------------------------o--o------------------------f---
m-E--------E---E------------------------------------------|-------------------------------E---------------|-----------------------------E-------------------------------E---------E--------------------X---
XXXXXXXXXXXXXXXXXXXXXXXXXXXXXXXXXXXXXXXXXXXXXXXXXXXXXXXXXXXXXXXXXXXXXXXXXXXXXXXXXXXXXXXXXXXXXXXXXXXXXXXXXXXXXXXXXXXXXXXXXXXXXXXXXXXXXXXXXXXXXXXXXXXXXXXXXXXXXXXXXXXXXXXXXXXXXXXXXXXXXXXXXXXXXXXXXXXXXXXXXXX
