-----------------------------------------------------------------------------------------------------------------------------------------------------------------------------------------------------------
-------------------------------o---------------------------------------------------------------------------------------------------------------------------------------------------------------------------
--------------------------------------------------------------------------------------------------------------------------------X--------------------------------------------------------------------------
-----------------------------------------------------------------------------------------------------------------------------------------------------------------------------------------------------------
-------------------------------------------------------------------------------------------------------------------------------------------------------------------------------------------------X---------
---------------------------------------------------------------------------B------X-o---------o------------------------------------------------------------------------------------------------------------
--------------------?--------------------------------------------------------------------------------------X------X----o---------------------------------------------o-------------------------------------
------------------------------------------------------------------------------------------------------------------------------------------------------------X------------------------------------------v---
---------------------------------------------------------------------????--------------------------------X?XXXXXXXXX?XXX-------XX-T--XXXXX-------------------------------------------------------------f---
-------------------------------------------------------------------------XXX------------------------------------------------------|--------------------------------------------------------------o----of---
--------------------------------------T-------BTBBBBBB-----------------------------XXXXXX--------BBBB----------------------------X|XXXX----------T-???-------------------------------------------------f---
--------------XXXXX-------------------|--------|-------------o------XXX--------BBB------------------------------XXXXXXXX----------|--------------|-----------------------------------------------------f---
--------------------------------------|-XXXXX-X|XXXXX-----------------------------------------------------------------------o-----|--------------|-----------------------------------------------------f---
-------------------------------XXXX--X|XXX-----|---------XBXXX----XXXXXXX------------------------------------------B--------------|------o-------|-----------------------------------------------------f---
m----------------------------------o--|--------|-------------------------------------------------E--------------------------------|----------o---|E----------------------------------------------------X---
XXXXXXXXXXXXXXXXXXXXXXXXXXXXXXXXXXXXXXXXXXXXXXXXXXXXXXXXXXXXXXXXXXXXXXXXXXXXXXXXXXXXXXXXXXXXXXXXXXXXXXXXXXXXXXXXXXXXXXXXXXXXXXXXXXXXXXXXXXXXXXXXXXXXXXXXXXXXXXXXXXXXXXXXXXXXXXXXXXXXXXXXXXXXXXXXXXXXXXXXXXX
