-T-o-----------------------E-----B-?----X--?-|----E----------TX-B--?--B-M--B--------------|X----B--o------T----------o---|---------|-|-----------o?------o-EoX------E--T------B-----B---|-----TM--------
-------o?--X---B-----------|----|M----M?-X----B--|--------------X----M--|XM?----------M----B-------o-----M--T--|-------BX-----------|Eo------|---------TB---M-|-------M--E---------------------------?--
------EEX-X--o--T---B-----------?-|----B--|--------T---B--|--B---------M-XM------------oXo----|----T-------E-?|M-----?-E---T--------o-o------B------o-M-|?-E-----B-T----T---T----EM---M--T---|-----?----
-----T---E?----E----X-B--X-------------M-X---------X--E-MX---|XB----TX-|-o-XBET-?--------|-o-ET---|B-|-M----B---X--T--T----M--------|-M------|-o--Eo-----?-------------------B----o----?M----B?|---T----
---oX-B------T-----o---E--o---o-X---B--o-|-T-|M|X-------M-o------o--T-E-------T-----------o----------BME?--B-M------E---T----BT-X---B---------o---TX-|--|?M|B-o--B-o?--o--------XB---X---?---E----|--M--
-E----T-?---B---o---X--T--T------Bo-BBT-------?---B-----?-------o---o---o-------------E-------o-E-------X-E---T-M---|-X--X-----------EoB-o-B-------T---||-M-BX-B-oB-B--?-------E-|MX------------T-oTT---
-|-M---E-------------M---B-M---|--E-----T---------E----------?M-E-B--o--?----------E-BE-----M---------------M---|-------------?-E---T|o----?----------M-T-----M--M--X-MM-E|-?-X-o--B-?M--------------BM-
--M---|----X-T-?------X-E---|----E---------Bo---T-M------B---ME--X-?---------|----XT-----X-------E----------------|EE-X-------?------M---------B-E---oB-----X---B--?-------o----E-|T-T--------M--?X-|BTv
-------M----X-------M--------M---?-------o-----M-o---M|-|---M-|---T-BT----T-o-M----E-----B-oTo-------X-o--B----E------------X-----B---B-------M------|--M----------B---T------BEM-----T---T-o-TM---M---f
---o--T--------B----------?-----?----------B---------X-------------E----M---B---T-------M------------|-M-X---------------------?---Xo--T------EX-------XT-----B---?-TE-X--|E-?-MTB--?T------------?-T-Xf
-------M--T-M---MX----XT---B----------X-|----------||-?------MB----------------T----TXT----T--M--B-------X-|-----|---|-o-E----?--------------oE|-T------------?--------------E|-oX-B-----?T------M----of
-X------------X---X--B---------|--ME---------M-----------T--o-?----M?B--------------?--E-------M-----B-------B-oM---M|-----o--|-----?-----X-T|----M-E----TT-o---M------T------M-|-ME----o-o--|----MT---f
--B?o-----?|E--|-?-----?------T-oBB---M-----o--o---?-----T----|-E----X|------------E--Mo--M-B--B----------X--|----E-?X---T-----B-ETM---E----oX-----------------M-B--?-|--T---T---|----oT-------T--E----f
---?-------||----|-------Xo-Mo------o---E----M?T--?------------E-T-----T-M-M--X-T-|E-|---------o------|---T---?o---o----M--X----------------?|----T------TB-BX-----X-o--X-?---|-MT----o--T|--X-X--?--T-f
m------E---|-X--|-T---M-?M-B--B---X|oo------??-E-M------------BM------------B|----------B-----T----------|-----|B----X----XB----o--------E-X-?------E-B----------X---oX-------E-X-T----------?-?-----M-X
XXXXXXXXXXXXXXXXXXXEXXXXXXXXXXXXXXXXEXXXXXXXXXXXXXXXXXXoXXXXXXXXMXXXXXXXXXXXXXXXXXXXXXXXXXX?XXXXXXXXXXXXXXXXXXXXXXMXXXXXXXXXEXXXXXXXXXXXXXXXXXXXXXXXXXXXXXXXXXXXXXXXXXXXXXXXoXXXXXXXXXXXXXTXXXXXXXXXXXXX
