-----------------------------------------------------------------------------------------------------------------------------------------------------------------------------------------------------------
-------------------------------------X---------------------------------------------------------------------o---------------------------------------------------------B------------?---?--------------------
-----------------------------------o-B---------------------------------------------------B----------------------------------------------o---o--o---------------------o--------------------------o----------
---------------------------------------------------------------------------X---------------------------------------------------------------------------------------------------------o---------------------
--------X--------------------------------------------------X-------------o----------------------------------o--------------------------------------------------o-------------------------------------------
--------------B--------------X----------------------------------------X------------B-----B-----o-----------------------------------------X------------X-----------------------X----------------------------
-------------o-o-------------------------------------o--------------------------------------------------------------------------X--X-------------------o----------------------o----------------------------
------------------------------------------B------o--o---------X----------------------------------o---o-------------------o-----------------------------------------------------------------------------v---
------o--------------X--------o---XXX-------X---------------------------------?-????-------X?X---XXX------XXXX------------------------------------BB--X---------------------------?--------------------f---
-------------------------------------------------------------o------------------------------------------------------------------XXXX------------------------------------------------o------------------f---
---------------------------o---o--------------------------------------------------------------BXX--BBBBB---------------------------------------------------------o-------------------------------------f---
--------------------------XXX--------------o--------------X--------o--------------------------X?XXXXX-----------XXXXX------------------------XB------o---------------------B---------------------------f---
--o----------------o----------------?--XXX------X----XX-------------------X--o-------o---------------------------------------------------------------T---------------------o----------o-------B--------f---
-----------------------------------------------------------------------------------------------------------------------------BXB-----------------XX-X|X-------o----------------------------------------f---
m--------------------------------------------------------------------------------------------------------E-------------------------------------------|------------------------------E------------------X---
XXXXXXXXXXXXXXXXXXXXXXXXXXXXXXXXXXXXXXXXXXXXXXXXXXXXXXXXXXXXXXXXXXXXXXXXXXXXXXXXXXXXXXXXXXXXXXXXXXXXXXXXXXXXXXXXXXXXXXXXXXXXXXXXXXXXXXXXXXXXXXXXXXXXXXXXXXXXXXXXXXXXXXXXXXXXXXXXXXXXXXXXXXXXXXXXXXXXXXXXXXX
