-----------------------------------------------------------------------------------------------------------------------------------------------------------------------------------------------------------
------------------------------o-------------------------------------------------o---X-----------------------------------------------------------------------------------o----------------------------------
-----------------------------------------------------?----------------------------------------BBBBBBBBBB----------BBBBBB---------------------------o-------------------------------------------------------
--------------------------------o-----------o-------------------------------------------------------------------o----------------o------------------------------------------------o-----------X------------
------------------------X---------------?--------------------------------------------E---------------------o---------------------------X-----o------------------------X-------o----------------------------
------------B?------B-------o--BB-----------o--XXXB-----o--BBBBB---------------BBBBBBB------------------BBBB-X----------------------XBBo---------?-B--------------------------X---------X------------------
---------------------------------------------------------?-----o----------------------------BBBBBBBBo---------BBBBB--BXB------------------------------------------BX?XX-------o---------o--o--------X------
--------------BBX-------------BBBBBBB-------XXXX----------------------BB-------BBBBX-------X-------------------------------????----------------------oBBBB---------------------------------------------v---
----------------------------------X------------------------B-------------------E----------------------------oXBB---------------------------------------------------------XXXXXXXX----------------------f---
-------------o---------------------------------TBBB----------o---------------BBB------BBBBBBBB----------XXXX----o----BBB------BB---B?BBBBBB---o---B-----------BBBBBXBB----------X----------------------f---
----X-----------------------------------------E|---------X--XT--------E----E---------E-o--------o-----------------------------------------------------------oX-----------------------------------o-----f---
--------------BXBo-----------BBBBB-----BBBBBXBX|BBXBB-o--??--|--BBXXXX?XX-BBBBB--BBB-BBBBBBXo---------BB--B?BBB-----????--BBBBB--BBB----TBBBBB-T--X--BBBBXX?--BBTB----BXBBB----------------------------f---
---o-------------------------------------------|-------------|----o----X---------------o-----T--X---o--o--------------------------------|------|---------------o|-----------------X--------------------f---
---------o-------------------o----------------o|-------------|-----------------B-o-----------|------------------------------------------|------|----------------|--------------------------------------f---
m-E--E------E--E--------E--------EE-----E----E-|----E-E---E--|---E-------------E-EE-EE---EE--|---E---EE-------E---E-----E--E------------|-E----|----------E-E---|----------------E-----E---------------X---
XXXXXXXXXXXXXXXXXXXXXXXXXXXXXXXXXXXXXXXXXXXXXXXXXXXXXXXXXXXXXXXXXXXXXXXXXXXXXXXXXXXXXXXXXXXXXXXXXXXXXXXXXXXXXXXXXXXXXXXXXXXXXXXXXXXXXXXXXXXXXXXXXXXXXXXXXXXXXXXXXXXXXXXXXXXXXXXXXXXXXXXXXXXXXXXXXXXXXXXXXXX
