-----------------------------------------------------------------------------------------------------------------------------------------------------------------------------------------------------------
-------------------------------------------------o---------------------------------------------------------------------------------------------------------------------------------------------------------
--------X--------------------------------------------------------------------------------------------------------------------------------------------------------------------------------------------------
-----------------------------------------------------------------------------------------------X-----------------------------------------------------------------------------------------------------------
-----------------------------------------------------------------------------------------------------------------------------------------------------------------------------------------------------------
---------------------------------------------------------------------------X-----------------------------o--------------------------o--o-------------------------------------------------------------------
--------------------------------------------------------------------------------------------------------------------------------------------------------?--------------------------------------------------
--------------------------------------------------------------------------o--------?-------------------------------------------------------------------------------------------------------------------v---
-----------------------------X-----------------------------------------XXXXXX---XXXXXX-------------------------------------------XXXXX---------BBBBBBBB---o--------------------------------------------f---
---------------------------------------------------??????-XXXXXX-------------------------------------XXXXXXX------------?X?????------------------------------------------------------------------------f---
--------------------------------------------o-----------------------------------------------------------------BBBBBBB---XXXXXXX------------------------XXXX--------------------------------------------f---
-----------------------------------XXXXXXXX--------------------------------------------------------------------BBBBBBB-???????o----------------------------------------o-------------------------------f---
------------------------------------------------------------------------XXX-X-------------------------T---------------------------------------------------------------------o--------------------------f---
--------------------X----------------------------?XXXXXXX---------------------------------------------|--------------------XXXXXXXX--------------------------------------------------------------------f---
m-----------------------------------------------------------------------------------------------------|-----------------------------------E--------------EE--------------------------------------------X---
XXXXXXXXXXXXXXXXXXXXXXXXXXXXXXXXXXXXXXXXXXXXXXXXXXXXXXXXXXXXXXXXXXXXXXXXXXXXXXXXXXXXXXXXXXXXXXXXXXXXXXXXXXXXXXXXXXXXXXXXXXXXXXXXXXXXXXXXXXXXXXXXXXXXXXXXXXXXXXXXXXXXXXXXXXXXXXXXXXXXXXXXXXXXXXXXXXXXXXXXXXX
