T-------T-------?-X---oT-------|----T--o--B-?----T-o-o--ME?-o----EB|-------X--o---X----|---|------B?----Xo----X-o-|?--MB?-E-----XX-o|---E-----------?M---|---T----X?------o---------T---Eo------?-----?M
X---B-------M--|?---?|-----B-----T?-------E-----?-----------o--|--X-------------------o|-E---X----M-------------E---o-T-----?-M--B-----E-o------?----M--------T---TTX---------------E-|-----B---?------B
M---------------------------M---B------o-----E---M--E---BT---E-|M--B----T|-E----------oM-----o-------X-?-----|---?B----------E--E?E--------M----o-------E--M---X----B---E--------------TE-M---?-M---B|o?
---BX---o?----T----o------o-----------B?X-----?--|-----E---|--E----o-----|--X--B-------X----?---M---oT-MX--o-------?----TM--M-------oE-----|B-|----o--------------|----|------T-------?o---|---------|-T
o-M-E--B-----T----------|--T--|M-B---------?---M--B----E---B-?X-X?--?--Mo----?oMM--------T----------------?----|T-T---E?-T--------o-M--E--M--------?X--?--X-MX----o-----|-X-?---------M-----------?-E--|
T----oB-X--------E---?--?oo-M--o---o-o--------------|------------M?-----------|------M-----oT---?-|-|---oT----------o|--E-----B---M-----X-BE-M?--------X--?-------Mo------|--M---o|--E--T-E----B---T---M
B----ET-----EM-B-E?----oM-T--------------------E-----------BE-X-----X---E--TM----o--X-|?--------B-----?--X--?--B---B-------B--M|EE----oEE----MX-------o--X----------|------ME?--|-T---X-----E------E---M
To----o-|--?--T---X-----B--|--o---X----------|-----E--B?------------X----------------E-M?---o-o-----E-ME----|-o----MoXT---E-------XT--M---?---?X|E----E------------E--Xo------X-----M----?--B-----||---v
T-B-|--------|--o--T---Bo-|-X-----M--M--|---?-----BET-X---X------?--E-----?-----o----------X-E-E-----o----------------E-M---B-?---o--TMBT-------?-?----T-B|M-----|X-------?-|----------?----------T--T-f
-----B----TX--------TET--o-?-----X--X|--o----X-----------o----|-|--X-----oB-?---M--M---B-----------M-----------T-----o--------?T-TT-X--M----o-------B-M?-M----oE----E---|T-?-|----T-|-E-X--BoT-X?-XBE-Bf
M---o--M---T--------|---------?---------?--T-B---T------------?-X-----------------o---X-----E-----E---T-|-o----MTB----B------E--------o|----------o--?X----B-B---EXT--?M-MX-------?-?BT------X---X--|-?f
B--------M-?----XX-B---------------T---BM----?-oE------M---ooE------M--oM--------?------o?-------T|----B?---X?---T|----E-E-------M-----------?--------B---Mo--X--?--------X--oX?---------|-X----|M-----f
oX-------B---B--E-oT-----E----EMo---------?--E----?-MX?----M-T------o--TXM--Xo|o-B---|--MT-T-o-Xo-----------T----o?-?--o----E--T------?--------o------------|------------|-------X------oE---?---|BB--|f
XM---------TMM---XXo-?--T-M----X-B-?---o---------o-------M--|----ToX-----M---X-----------------M---XB--X-------------EX--B-|--------E------B----|o-E-------?--X--X-XE---XT-B----------|-M---|-ToXBo---Tf
mB-?E--?|E---X----TEM-----o|?EE-----X-|-o----o?-M-M--oM--M--BT?-----E--------?-----BM--X---|--oTX-T-----B-----?-E|----T-------XB-------E---o---|------|-------XEX|-T------?------o-----M---M----T--o-M-X
XXXXXXXXXXXXXXXXXXXXXXXXXXXXXXXXXXXXEXXXXXXXXXXXXXXXXXXXXXXXXXXXXXXXXXXXXXXXXXXXXXXXXXXXXXXXXXXXXXXXXXXXXTXXXXXXXXXXXXXXXXXXXXXXXXXXXXXXXXXXXXXXXXXXXXXXXXXXXXXXXXXXXXXXXXXXXXXXXBXXXXXXXXXXXXXXXXXEXXXX
