-----------------------------------------------------------------------------------------------------------------------------------------------------------------------------------------------------------
-----------------------------------------------------------------------------------------------------------------------------------------------------------------------------------------------------------
------------------------------------------------o----------------------------------------------------------------------------------------------------------------------------------------------------------
-----------------------------------------------------------------------------------------------------------------------------------------------------------------------------------------------------------
-----------------------------------------------------------------------------------------------------------------------------------------------------------------------------------------------------------
----------------------------X-------------------------------------------------------------------------------------------------------o----------------------------o-----------------------------------------
-----------------------------------------------------------------------------------------------------------------------------------------------------------------------Xo----------------------------------
--------------------------------------------X----------------------------------------------------------------------------------------------------------------------------------------------------------v---
-----------------------------------------------------------------------------------------------------------------------------------------XXXXXXXX------------------------------------------------------f---
---------------------------------X---T-----------------------------------------------------------------------------------------o-----------------------------------------------------------------------f---
-------------------------------------|-----------------------------------X-----------------------------------------------------------------------------------------------------------------X-----------f---
-------------XXX-------XXXXXXXX--XXXX|-----------------XXX-------------------------------BBBBBBB----XXXXXXX-????????---------XXXXXX--XXXXXXX-------------XXXXX-----------------------------------------f---
-------------------------------------|---------------------------------------------------------------------------------T-------T-----------------------------------------------------------------------f---
-------------------------------------|---------------------------------------------------------------------------------|-------|----o------------------------------------------------------------------f---
m---------o--------------------------|-------------------------------------------------------------------------------E-|-------|-----------------------------------------------------E----------o------X---
XXXXXXXXXXXXXXXXXXXXXXXXXXXXXXXXXXXXXXXXXXXXXXXXXXXXXXXXXXXXXXXXXXXXXXXXXXXXXXXXXXXXXXXXXXXXXXXXXXXXXXXXXXXXXXXXXXXXXXXXXXXXXXXXXXXXXXXXXXXXXXXXXXXXXXXXXXXXXXXXXXXXXXXXXXXXXXXXXXXXXXXXXXXXXXXXXXXXXXXXXXX
