-----------------------------------------------------------------------------------------------------------------------------------------------------------------------------------------------------------
-----------------------------------------------------------------------------------------------------------------------------------------------------------------------------------------------------------
-----------------------------------------------------------------------------------------------------------------------------------------------------------------------------------------------------------
----------------o-------------------------------------------------------o------oo-----------------------------------------------------------B--------------------------------------------------------------
-------------------------------------B-----X-------------------------o-------------------------------------------------------------------------------------------------------------------------------------
------------------------------------------------------------------------------------------------o-------------------------------------------------------------------B--------------------------------------
-----------------------------------------------------XXXX----------o-----------------------XXXXXX------X----------------------------------------------------------------------------------X----------------
---------------------XXX---------------------XXXXXXX----------------------------------------------------------------------------------------------------X-------o--------------------------------------v---
-------------------------------------------------------------------------------------------------------------------------------------------------------------------------------------------------------f---
----------------------------------------------------------------------------------------------o------------X----------------X--------------------------------------------------------------------------f---
---------------------------------------------o-o------------------T--------------X---------XXXXXX------------------------------------------------------------------------------------------------------f---
-------------------XXXXXXXX--------------XXXXXX-X-----------XXXXX-|-------------------XXX??----------------????--XXXXXXX--------XXXX-----------------XXXXXXX-------------------------------------------f---
------------------------------------------------------------------|----------------------------------------------------------------------------------------------------------------------------------X-f---
------------------------------------------------------------------|------------------------------------------------------------------------------------o-----------------------------------------------f---
m---------------E-----o-------------------------------------------|----------------------------------------------------------------E----E-------------E------------------------------------------------X---
XXXXXXXXXXXXXXXXXXXXXXXXXXXXXXXXXXXXXXXXXXXXXXXXXXXXXXXXXXXXXXXXXXXXXXXXXXXXXXXXXXXXXXXXXXXXXXXXXXXXXXXXXXXXXXXXXXXXXXXXXXXXXXXXXXXXXXXXXXXXXXXXXXXXXXXXXXXXXXXXXXXXXXXXXXXXXXXXXXXXXXXXXXXXXXXXXXXXXXXXXXX
