-----------------------------------------------------------------------------------------------------------------------------------------------------------------------------------------------------------
------------------------------------------------------o----------X-------------------------------o-------------------------------------------------------------o-------------------------------------------
---------------------------------------------------------------------------------------------------------------------------------------XXBXB---------------------------------o----------------------?------
------------------------------------------------------------o--------------------------------------------------------------------------------------------------------o--o----------------------------------
------------------------------------------B------------------------------X----BB---?-------------------------------o------------------o-------------------------------------------o--------------o---------
----------------------------------------------------------------B------------------------------BBB----------X----------------B---------------o-------------------BBBXBBB-----------------------------------
----------------------o-------------------------------------?----------oo--------------------------?--------o----------------------oXBBBBBBB------------------------?--------------------------------------
---------------------------------BBB-------------BB------o--------------------B---------------------------------X---BBBBB-------------------o----------------------------------------------------------v---
------------------------------------------------T-------X-----------BBBBBB?BBB---o-------------BBB--------------------------------------------o-----------------------X--------------------------------f---
--------------------X-------------------o-------|o------BBBX--o----------------------BBBB-------------------------------------------X?????--------------------BXB-BB-----------------------------------f---
------------------------------------------------|-----------------T------------------------o-------------o-------------------------------------o-------------------------------------------------------f---
----o--------------BBBB--T-------XXXX---------BB|B--BBBXBBB-------|BXBB?BB-------?XX-TBBB----BBBBBB--------X-----BXBBBBBB----?X????X?----------------------???????X------------------------o-----------f---
-------------------------|----------------------|o--------------T-|-----------T------|-------------------------------------------------------------------------------------o---?-----------------------f---
----------------------o--|X---------------------|---------------|-|-X---------|------|-----------------------------------------------------------------------------------------------------X-----------f---
m------------------------|-------E--------------|-----------E---|-|--------E--|E-----|---------------------------------------------------o----------------------------E--------------------------------X---
XXXXXXXXXXXXXXXXXXXXXXXXXXXXXXXXXXXXXXXXXXXXXXXXXXXXXXXXXXXXXXXXXXXXXXXXXXXXXXXXXXXXXXXXXXXXXXXXXXXXXXXXXXXXXXXXXXXXXXXXXXXXXXXXXXXXXXXXXXXXXXXXXXXXXXXXXXXXXXXXXXXXXXXXXXXXXXXXXXXXXXXXXXXXXXXXXXXXXXXXXXX
