----M-------B-B--------X-------oM-X--|-------------B---------?M---M-----------oB----------X-T------|---ETT------M-E---o-M---------M-----------------E------------------X-T-M-|-X----o---B--?--T---M-----
--|----T---E--------o-|M------B---B-------XB------T-E-----------Xo-X-o-E?E---M----|-E----B|---------|--BEB------------------E---X---XM-------B-T---------T----o?-?----MM-M-o---|-o-----X------------M-M-
----E-----------?-E-XM--?MM-B-M|?------o--XEM---T-|--B--E--E---X----B---|----T----------------M-?-----M---------T-------|--ET---T--ETo|?--------T-----T-----------E---B?---E-------T---X-T--M-----------
-----M-o-------?M-------------------X-----M------MT-----E--B-E-------E-------M--M----BT-----o----o-----------------T---?|--------E-B---XM--EE-----|-E-E-------M--TB----|--------Xo----|-----?--M-E--?---
-------?---------|-----M---M-?X-|-----EE-------E-?T-EE-------|---B---E-T-XX---------E-M-o-M----------?--E--------------------BMT-?B------?--T--?-M------o---E---------E-------X----------------------M--
----------|E------|------E--X----|---T-----E---B----B--------------------------T---------X-M------M|B------|-T?o-------M---|-----|B---?--EX-----o-XM?--|--|-oE-TB------?---------o-T----X----o?----o-E--
-----B-----------X---oo------------|?o----TX--|-?--B-------------B--E--?---M------o--TE----|-----|-T-----------?-M--M--M-------B-E-?--ME--o----|T-E-------------o---------B-X--Xo?-T-----|----T?--M-----
-M-M-----E--B----Mo-----|----X-|-----------M----|--X-?----o-------?-------?M---XX--------?--B------M-T-|-T--B-----E-o-|B|?---T-------X-M--------------B-|-|------|------T?BT----------X--X-------X-----v
-----T---------X---M--o-TX--M-B--M----------X--T---M-------T----------|---?----E-X----------E---|---oMB?-----------B--E-EB-B-M----|---E------E--|-----------|---T-------|TM---|--E--E--o--B---B-?-E----f
-X-oM------B--X--------|E----T--------?-X--M?E-X-----ME-T---T--|--T--M-------|B-----------B-----|--o-------M--X--------T--|-------------o-?-------B----------------T--M-oM------T---M----T--M--MM--E-o-f
----oo--|-M-M-----------Bo---------------|--?--E-M-E-----M?E-EB-----T------X--oMoM------o----o-----oM-B|--?------X-------E--BXTo----------o--?-EB---B-To-------o----XT-?---|-E|---?-------B--X----E|-o-f
-----------------E-------oMo-----o------------o--E|-XBMM---BE-M--o---M-?----MT----M-----|----M---T-T------X--E----M---oX-------------X---M---?----oX-M---T-----BM----o--E-?|-E---------E-EB------------f
--M-----------X--E---X--B-B-T-B?-?----------|B----M-----?T---X------o-|E--X---------------T-----?-M--|------B---ETB-MT-------X----o-o-------T-X-E------------------MX-----------X---|--------------E|-Tf
------------T-M-M---o--T-B-|-o?----B--o------X----X|--X---o--o--|--------|---------------T-|---?---X-?-o--B----o|----X-----X--X-T---oo-T------?----T?----|-|--?-?-----M-|o---?-?-B--o--------Bo-----T?of
m------------------------------------------------------------------------------------------------------------------------------------------------------------------------------------------------------X
XXXXXXXXXXXXXXXXXXXXXXXXXXXXXXXXXXXXXXXXXXXXXXXXXXXXXXXXXXXXXXXXXXXXXXXXXXXXXXXXXXXXXXXXXXXXXXXXXXXXXXXXXXXXXXXXXXXXXXXXXXXXXXXXXXXXXXXXXXXXXXXXXXXXXXXXXXXXXXXXXXXXXXXXXXXXXXXXXXXXXXXXXXXXXXXXXXXXXXXX
