-----------------------------------------------------------------------------------------------------------------------------------------------------------------------------------------------------------
-------------------------------------------------------------------------------------o--------------------------------------------------------------------o-----------------------o------------------------
---o-------------------------------------------------------------------------------------------------------X--------------------------------------o--------------------------------------------------------
------------------------------------------------?---------------------------------------------------------------------------------------------------------------o------------------------------------------
--------o-------------o------------o------------o-----------o--------------o-----X-------?-----------------------------------------------------------------------------------------------------------------
------------------------------------------------oX----X------------o--------------------------------o---------?-----------------------o----------------------------o-------------------------X-------------
--------------------------X---------X---------------------------------------B------------------------------------------------------------------------------------------------------------------------------
--------?---------------------------------------------XXXXX------------------------B----------------------------------X----------------------------------------------------------------------o---------v---
-----o--------------------X-----------X-----------------------T---------------------------XXXX-----------------------------o-------------------------------B--------------o---------?------------------f---
----------------------------------------------------XXX-------|-----------------------------------------------------o--------o---------------------------------------------------?---------------------f---
-------------------------------------o----------------------o-|----------------XT--------------------o--------------------------------------------------------------------X----------------------------f---
----------------------o--------------XXX------------XXX----XXX|----XXXXXXXX-XXX-|---XXXXXXX---XXXX-----------------XXX-----XXXXX---XXXXXXXX----XXX-B--------------------B------------------?-----------f---
-----------------o----------o---------------------------------|--o---------oo---|------o-----------T---o--------------------------------T----------------------T-------------?------------------------of---
--------------------------------------------------------------|----o------------|------------------|-----------------------------------o|----------------------|---------------------------------------f---
m-E---------------------------------------------E-------------|-----------------|------------------|---------E--------------------------|---E---E--------------|-----E---------------------------------X---
XXXXXXXXXXXXXXXXXXXXXXXXXXXXXXXXXXXXXXXXXXXXXXXXXXXXXXXXXXXXXXXXXXXXXXXXXXXXXXXXXXXXXXXXXXXXXXXXXXXXXXXXXXXXXXXXXXXXXXXXXXXXXXXXXXXXXXXXXXXXXXXXXXXXXXXXXXXXXXXXXXXXXXXXXXXXXXXXXXXXXXXXXXXXXXXXXXXXXXXXXXX
