-----------------------------------------------------------------------------------------------------------------------------------------------------------------------------------------------------------------
--------------------------------------X-------------------------------------o------------X-----------------------------------------------------------------------------------------------------------------------
----------------------------------------------o-----------------------------------o------------------o-----------------------------------------------------------------------------------------------------------
--------------------------o-------------------------------------------------------------------------------------------o------------------------------------------------------------------------------------------
-------------------------X-------------?--------------o---------o-------X------------------------------?--------------------------o------------------------------------------------------------------------------
---------------------------B---------------------------------------------------o--------Bo----------------------------o-BBBBXBBB--------------------------------X------------X-----------------------------------
--------------------------------------------------X-------------------------------------------------------o------------------------------o----------------------X--------------------B---------------------------
----------------o---------------------------------------------------------------------XX-----------------BBBB---------------------------------------------X--------------------------------------------v---------
----------------------T---------------------------------------o----?BB-----------------------------o-----------o--------------------------BBBBBBBB----------------------------X--------o---------------f---------
-----------X----------|------B------------B-BBBB---o------------o----------o---------------------------o--o-------------XXXXX----------------X---------------?---------o-------------------------------f---------
----------------------|----------------------------T------------------------------To----E--X----------------------------------------------------o---------o--------------------------------------------f---------
--------------BB--BBBB|BB-B?----B-------?-o--------|-------TT--BB----------BTBB-B-|----BB-B-------------BBBB----BBBB?????---------BXBBBBBBXBBBBBB-------------------BBBB------------------------------Xf---------
----------------------|----------------------------|-------||T--------------|-----|-----T------------------------------------------------X-------------------------------------------------------------f---------
-------?--------------|--o-------------------------|-------|||--------------|-----|-----|----------------------------------o---------------------------X-----------------------------------------------f---------
m---------------------|----------------------E-----|-------|||--------------|-----|-----|--------------------------------o----------------------------------o---E-----------E-----E--------------------X---------
XXXXXXXXXXXXXXXXXXXXXXXXXXXXXXXXXXXXXXXXXXXXXXXXXXXXXXXXXXXXXXXXXXXXXXXXXXXXXXXXXXXXXXXXXXXXXXXXXXXXXXXXXXXXXXXXXXXXXXXXXXXXXXXXXXXXXXXXXXXXXXXXXXXXXXXXXXXXXXXXXXXXXXXXXXXXXXXXXXXXXXXXXXXXXXXXXXXXXXXXXXXXXXXXX
