-----------------------------------------------------------------------------------------------------------------------------------------------------------------------------------------------------------
---------------------o------------------------------o----------------------------------------------------B------------------------------------o------------------------------------------------------------
---------------------------------------------------------------o------------------o------------------------------------------------------------------------------------------------------------------------
-------------------------------------------------------------------------------------------------------------------------------------X------------------o-----------------------------------------o--------
----------------X----------o----------------------------------------------o----------------X---------------------------------XXXX--------------------------------------------------------B-----------X-----
----------------------o-------?------X-------B----o-X??X?o-----------------------------------------------------o---------------------o--------------------------X------------------------------------------
-o-------------------o----------------o---o----------------------------------------------------------o------------------------X---------o------------------------------------------------------------------
-----------------------------oo--------------o------?--------------X-----XXXXXX---o-------XBBBBB----------------??------XXXXXXX--------------------------?------------------------------o--------------v---
-----------?-----------------------o---------------------------------------------------------------------o----------------------------------X---------XXXXXX----------X--------------------------------f---
--------------------------------------------------XXXX---------o------------???????-----------------o-----o-------------------------------------------o---------------------X--------------------------f---
---------o--------------------o-o--------------------------------------------------------------------------o----------------------------------------T--------------------------------------------------f---
------------XX----XXXX-----------XXX------------XXX-------TXXX------XBBB-BBBBBB---o-----XXX??X-XXXXXXXX---------XXXXXXXXX-XXX---------------------XX|XXX----X-------o----XXXXX-X----------------------of---
----------------------------------------------------------|------------------------------o--------------------B-------------------------------------|----X-------------------X-------------------------f---
----------------------------------------------------------|-----------------------B-------o----------X----------------------------------------------|---------o---------------------o--------B---------f---
m-E--------E---E------------------------------------------|---------------------------E-------------------------------------------------------------|-----------------------------E--------------------X---
XXXXXXXXXXXXXXXXXXXXXXXXXXXXXXXXXXXXXXXXXXXXXXXXXXXXXXXXXXXXXXXXXXXXXXXXXXXXXXXXXXXXXXXXXXXXXXXXXXXXXXXXXXXXXXXXXXXXXXXXXXXXXXXXXXXXXXXXXXXXXXXXXXXXXXXXXXXXXXXXXXXXXXXXXXXXXXXXXXXXXXXXXXXXXXXXXXXXXXXXXXX
