-----------------------------------------------------------------------------------------------------------------------------------------------------------------------------------------------------------
------------------------------------------o------------------o------------------------------------------------------------X-----------------o--------------------------------------------------------------
-----------------------------------------------------------------------------------------------------------------------------------------------------------------------------------------------------------
------------------------------------------------------------o-----------------------------------------------------------------------------o----------------------------------------------------------------
----------------o---------------------------------------------------------------------------------X-------------------------------------X------------------------------------------------------------------
------------------------------------------------------------------------------X---------------------------------------------------------------------------------------------------------o------------------
------------------o------------------------------------------o----------------------------------------------------------------o-------------------------------o--------------------------------------------
----------------------o--------------------------------------------------------------------------------------------------------------------------------------------------------------------------------v---
-----------------------------------------XXXXBXX-X---------XXXXX----------XXXXXX-----------------------XXXX----------o-------------------------XX------------------------------------------------------f---
------------------------------------XXXXXX---------------------------------------------------------------------XXXXXXBX--------------------------------------------------------------------------------f---
------------------------------------------------------XXo---------------------------------------------------------------------------XXXX---------------------------------------o-----X-----------------f---
---------------------------------------------------------------o-------------------------------------T------------------------------------------------------------------------------------------o------f---
------------------------------------T--------XXXX------------------------XXXXXX-------------o--------|-----------------T-----------??------------X-----------XXXXXXXX-------------?---------------X----f---
-------------------------o---XXXXXXX|-------------------------------------------------------------o--|-----------------|-------------------------------------------------------------------------------f---
m-E---------------------------------|-----------------------------------------------E----------------|-----------------|---------------o---------------------------------------------------------------X---
XXXXXXXXXXXXXXXXXXXXXXXXXXXXXXXXXXXXXXXXXXXXXXXXXXXXXXXXXXXXXXXXXXXXXXXXXXXXXXXXXXXXXXXXXXXXXXXXXXXXXXXXXXXXXXXXXXXXXXXXXXXXXXXXXXXXXXXXXXXXXXXXXXXXXXXXXXXXXXXXXXXXXXXXXXXXXXXXXXXXXXXXXXXXXXXXXXXXXXXXXXX

