-----------------------------------------------------------------------------------------------------------------------------------------------------------------------------------------------------------
-----------------------------------------------------------------------------------------------------------------------------------------------------------------------------------------------------------
-----------------------------------------------------------------------------------------------------------------------------------------------------------------------------------------------------------
-----------------------------------------------------------------------------------------------------------------------------------------------------------------------------------------------------------
-----------------------------------------------------------------------------------------------------------------------------------------------------------------------------------------------------------
-----------------------------------------------------------------------------------------------------------------------------------------------------------------------------------------------------------
-----------------------------------------------------------------------------------------------------------------------------------------------------------------------------------------------------------
-------------------------------------------------------------------------------XXXXXXX---------------------------------------------------------------------o-------------------------------------------v---
-----------------------------------------------------------------------------------------------------------------------------------------------------------o-------------------------------------------f---
--------------------------------------------------------------------------------------------------------------------------------T----------------------------------------------------------------------f---
--------------------------------------------------------------------------------------------------------------------------------|----------------------------------------------------------------------f---
------------------o---------------------------------XXXXXX----------XXX------BBBBBBBB------------------------------------------X|XXXXX------XXXXXX--------XXXX-----------------------------------------f---
----------------------T-----------------------------------------------------------------o---------------------------------------|----------------------------------------------------------------------f---
----------------------|---------------------------------------------------------------------------------------------------------|----------------------------------------------------------------------f---
m---------------------|----------------------------------------E----------------------------------------------------------E-----|----------------------------E---------------------------------------E-X---
XXXXXXXXXXXXXXXXXXXXXXXXXXXXXXXXXXXXXXXXXXXXXXXXXXXXXXXXXXXXXXXXXXXXXXXXXXXXXXXXXXXXXXXXXXXXXXXXXXXXXXXXXXXXXXXXXXXXXXXXXXXXXXXXXXXXXXXXXXXXXXXXXXXXXXXXXXXXXXXXXXXXXXXXXXXXXXXXXXXXXXXXXXXXXXXXXXXXXXXXXXX
