-----------------------------------------------------------------------------------------------------------------------------------------------------------------------------------------------------------
------o-----------------o------------------------------------------------------------X--o------------------------o-----------------------------------------------------------------------------------------
----------------------------------------------------------------------------------------------------o-------------------------------------o----------------------------------------------------------------
--------------o-----------o------------o-----o---------------------------------------------------------------------------------------------------------------------------------------o-------------o-------
--------------o---------------------------------------------------------------------------------------------?--------------------o-------------------------------------------------------------------------
----------o----------------------------------o------------------------------------------X---------o------------------X-------------------------------------------------------------------------------------
----------------------------------------X--o------------------------------------------------------o--------------------------------------------------------------------------------------------------------
----------------?--o--------------------------------------------------------------------------------------------X--------------------------------o-------------------------o--------------------------ov---
-----X-----------------------???X?-----------------------------XXXXXX----------o------------B--------------------------------------------X------------------BBB----------------------------------------f---
---------------o-------------------------------------XXXX-----------------XXXBBBXXX---------------o----------------------------o----------------XXXXXX-----------------------------------o-------------f---
-----------------------XXX-------------------------------------------------XXXXX---------------------------------------XXXXXXXX------o--------------------XXX-------------------o----------------------f---
-------------------o-XXX--------------------------------------------???------------------------XXXXXXB-----------------------------------------------------------------------------------------X-------f---
------------------------------------------------T--------B--------XXXXXXX---------------------------XX---------B-------------------------XXX----------------------------------------?------------------f---
---------------------------XXX--XXXXXXX---------|-------------------------------------------------------o---XXXXXX-------------------o-----------------------------------------------------------------f---
m----------------------------------------E------|-E------E---------------------------------------------------------------------------------------------------------------------------------------------X---
XXXXXXXXXXXXXXXXXXXXXXXXXXXXXXXXXXXXXXXXXXXXXXXXXXXXXXXXXXXXXXXXXXXXXXXXXXXXXXXXXXXXXXXXXXXXXXXXXXXXXXXXXXXXXXXXXXXXXXXXXXXXXXXXXXXXXXXXXXXXXXXXXXXXXXXXXXXXXXXXXXXXXXXXXXXXXXXXXXXXXXXXXXXXXXXXXXXXXXXXXXX
