-----------------------------------------------------------------------------------------------------------------------------------------------------------------------------------------------------------
-----------------------------------------------------------------------------------------------------------------------------------------------------------------------------------------------------------
--------------------------------------------------------------------------------------------------------------------------------------oXXX-X--------------------------------------------------o------------
------------------------------------------------------------------------------------------------------------------------------------------------------------------------------------o-----X----------------
-----------o---------------------------------------------o----o---------------BB--------------------------------------------------------------------------------------B----------------o-------------------
------------------------------------------------------------B-------------------------------oo----------X-----------------o------------------------------------------------o-------------------------------
------------------------------------------------------------------------o--------------------------------------------------X-X------BBBBBBBB-----X---------B-----------------------------------------------
---o---------B--o---------------------------X-----------------BB--------------B----------o---------------------------BBBB-----------------------------------------?-----------------o------------------v---
-------------------------------------------B------------------------BBBBBBBBBB------------o--BXBBB-----------------------------------------------------o-----------------------------------------------f---
----------------------------------?--------------------------X-------------------?---------?----------------------------------------??????-------------------------------------------------------------f---
----------------------?-------------------------------------------T------------o-------------E----------------Eo-------------------------------------------T-------------------?-X---------X-----------f---
---------------BBBBB-----XBTBB---BBBoBBBBBBXXXXX-XXXXBBBBBBB------|BBBBBBB-------??????-----BBBBBBB---TBXBXBBBB--BBBBBXBB----????????------------------XX--|------BBB----------------------------------f---
----------------X----------|--------------------------------------|-----------T-----------------------|--------------------X----------------------------o--|-------------?-------------------o---------f---
---------------------------|--------------------------------------|-----------|-----------------------|----------------------------------------------------|----o------X-------------------------------f---
m---------E----------------|--------------------------------------|--------E--|E----------------------|----------------------------------o-----------------|------E------------------------------------X---
XXXXXXXXXXXXXXXXXXXXXXXXXXXXXXXXXXXXXXXXXXXXXXXXXXXXXXXXXXXXXXXXXXXXXXXXXXXXXXXXXXXXXXXXXXXXXXXXXXXXXXXXXXXXXXXXXXXXXXXXXXXXXXXXXXXXXXXXXXXXXXXXXXXXXXXXXXXXXXXXXXXXXXXXXXXXXXXXXXXXXXXXXXXXXXXXXXXXXXXXXXX
