--------------------------------------------------------------------------------------------------------------------------------------------------------------------------------------------------------
--------------------------------------------------------------------------------------------------------------------------------------------------------------------------------------------------------
---------------------------------------------------------------------------------------------------------------o----------------------------------------------------------------------o-----------------
--------------------------------------------------------------------------------------------------------------------------------------------------------------------------------------------------------
---------------------------------------------------------------------------------------------------------------o----------------------------------------------------------------------------------------
----------------------------------------------------------------------o-----------------------------------------------------------------------------------------X---------------------------------------
---o------------------------------X---------------------------------------------------------o-----------------------------------------------------------------------------------------------------------
-------------------------------o--------------------------------------------------------------------------------------o--------------------------------------------------------------------------------v
---------------------------------------------------------------------XXBX-----B----------------?????------XXX----------------------BXXXXX------XXX------------------XXXX-------------------------------f
----------------------------------------o---------------------------------------------------T--------------------XXXXXX--------------------------------------------------------------------------------f
-----------------------------------------------XXXTX---o------------------------BB----------|-----XXXXX--------------------------------XXXXXXXB-------BBBBB--------------------------------------------f
---------------------------------------BBBBBBBB---|-----------????B???------------o---B-----|-----------------------------------------------------------------------XXXXXXX----------------------------f
------------------------------------XXXXXXX-------|------------------------------XXXXXX-----|-------------------------------------------------XXXXX----------------------------------------------------f
---------o------------------XXXXXX-------XXXXXXXXX|-----------XXXXXXXX----------------------|--------------------------------------------------------------o-------------------------------------------f
m-E-----------------------------------------------|----------E-E----------------------------|-o------E-----------------E-------------------------------------------------------------------------------X
XXXXXXXXXXXXXXXXXXXXXXXXXXXXXXXXXXXXXXXXXXXXXXXXXXXXXXXXXXXXXXXXXXXXXXXXXXXXXXXXXXXXXXXXXXXXXXXXXXXXXXXXXXXXXXXXXXXXXXXXXXXXXXXXXXXXXXXXXXXXXXXXXXXXXXXXXXXXXXXXXXXXXXXXXXXXXXXXXXXXXXXXXXXXXXXXXXXXXXXX
