-----------------------------------------------------------------------------------------------------------------------------------------------------------------------------------------------------------
--o-o-------------------X----------------------------------------------------------------------------------------------------o--------------------------------------o---------------------------X----------
------------------------------o----------------------------------------------------------------------------------------------------------------------------------------------------------------------o-----
---------------------------------------------------------o---------------------------------------------------------------------o-----o--------------------------------------------------?------------------
--------------------------------------------------o------------------------------------o-------------------------------------------------------------------------------------o-----------------------------
-o---------------------------------------X---------------------------------------------?--------------------------------------------------------------------------?-----------------------------o----------
----------------------------------------------------------------------------?-----------------------------------------o------------------------------------------------------------------------------------
-------------------------------------------------------------------------------------------------------------------------------------------B------------------------X----------------------------------v---
----------------------------------------o--------------------XXXXXXXX------X----------------------------XX------T--------------------------------------------T-----------------------------------------f---
-------------------------o----------XXBXX?XX-----------------------?X?------------------BXB--------------o------|------XXXXXXXX------------------------------|----------------------o-----------------Bf---
------------------------------------XXX----------------------------------XXXXXX---------------------------------|--B----------------------XXXXXXX---------B-B|B----XXXX-----------------------o--------f---
--------------------------------------------------------------------XXXXXX--------------------------------------|------------XXXXX-----------T---------------|----o-----------o------------------o-----f---
-----------------------------------------------------------XXXXXXB-----------------------------------------X-XXX|X---------o--oX----XX--XXTX-|---------------|-----------------------------------------f---
--------------------------------XXXX----------------X-XXXXXXX---------------------------------------------------|-------------------------|--|-----XXXX------|--------------X--------------------------f---
m-E-----------E--------------------------------o----------------------------------------------------------E-----|-------------------------|--|---------------|-----------------------------------------X---
XXXXXXXXXXXXXXXXXXXXXXXXXXXXXXXXXXXXXXXXXXXXXXXXXXXXXXXXXXXXXXXXXXXXXXXXXXXXXXXXXXXXXXXXXXXXXXXXXXXXXXXXXXXXXXXXXXXXXXXXXXXXXXXXXXXXXXXXXXXXXXXXXXXXXXXXXXXXXXXXXXXXXXXXXXXXXXXXXXXXXXXXXXXXXXXXXXXXXXXXXXX
