--------------------------------------------------------------------------------------------------------------------------------------------------------------------------------------------------------
----------------------------------B-------------------------------------------------------------------------------------------------------------------------------B-------------------------------------
-----------------------------------------o---------------------------------------------------------------------------------------------------------o----------------------------------------------------
----------------------------------------------------------------------------------------------------------------------------------------------------------------------o-----------------------------o---
------------------------------------------------------------------------------------------------------------------------------------------------------------------------------------------o-------------
--------------------------------------------------------------------------------------------------------------------------------------------------------------------------------------------------------
-----------------------------------------------------------------------------------------------------------X--------------------------------------------------------------------------------------------
-------------------------------------------------------------------------------------------------------------------------------------------------------------------------------------------------------v
-----------------------X--------------------------------------------------------------------XXXXXX--------------------------------o----------------------------------o---------------------------------f
--------------------------------------------------------------------------------------------------------------XXX-----------T-----XXX-----------XXX--------------------------------------X-------------f
-------------------------------------------------------------------------------------------------------T--------------------|---------------------------------------------------------------o----------f
------------------------X--------------------------XXX------XXXX----????????--------------------XXXXXXX|---------------XXX--|--XXXXX-------------------------------------------------------------------f
--------------------------------------------XXXXXXX----------------------------------------------------|--------------BBBB--|--------------------------------------------------------------------------f
-----------------------------------------------oXXXXX--------------------------------------------------|--------------------|--------XXXXXXX-----------------------------------------------------------f
m-E----------------------E-----------------------------------E---------EE------------------------------|--------------------|------------------------------------------------E---------------------E---X
XXXXXXXXXXXXXXXXXXXXXXXXXXXXXXXXXXXXXXXXXXXXXXXXXXXXXXXXXXXXXXXXXXXXXXXXXXXXXXXXXXXXXXXXXXXXXXXXXXXXXXXXXXXXXXXXXXXXXXXXXXXXXXXXXXXXXXXXXXXXXXXXXXXXXXXXXXXXXXXXXXXXXXXXXXXXXXXXXXXXXXXXXXXXXXXXXXXXXXXX
