-----------------------------------------------------------------------------------------------------------------------------------------------------------------------------------------------------------
---o-----------------------------------------------------------------------------------------------------------------------oB------------o--------o---?----------------------------------------------------
--------------------------------------------------o--------------------------------------------o-------o---------------------------B--------------------------o----------------------------?---------------
--o--B-------------X------------------------?------------------------------------------------------------o----------------------------------B--------o-------------o---------------------------------------
----------------------------------------------------?-------------------BBB--------------------------------------------------------------------------------------------------------------------------------
---------------------------------------------------o-----X---------------------------------------------X---------B-----?XX?------------o---?----------X-----o--------X-------------------------------------
--------B-----------------X-------X------o--------------o---------------o-------------------------o-----------o------------------------------o------------------------------------------------o-----o------
-B-------B--------------------------------X----------------------------B---------?--------------?-----------------BBB------------------------------------------------------X--------X------------------v---
----------------------------------------------------X---------------------------X-------------------------------------XXXX----------------------------T------------------------------------------------f---
--------------------------------------------------o--o---------X----------------------o-o---------------------------------------------------------o---|------o---------------------X-------------------f---
-----------o----------o---o----------------oo---------------------------------------------X-------------------------------------------B---------------|--------------X---------------------------------f---
-----------------------B--X-BBB-BBXXXX------------X------X-BBB-BB---BBBB-B--BB-B--------B-B-B------T----------o--X????X-------BBBBBBBB------------?X?X|B?-------------o---------------o---------o---o--f---
-------------------o----------------------------------------------------T--o-----------------------|------------T-------------------------------------|-----------------------------B---------X--------f---
---------------------?------------------------------------------o----o--|--------o-----------------|------------|------------o---------X--------------|------o-o----------------o-------X--------------f---
m-E-----------------------------------E---------------------------------|--------------------------|------------|-------------------------------------|-----------------E------------------------------X---
XXXXXXXXXXXXXXXXXXXXXXXXXXXXXXXXXXXXXXXXXXXXXXXXXXXXXXXXXXXXXXXXXXXXXXXXXXXXXXXXXXXXXXXXXXXXXXXXXXXXXXXXXXXXXXXXXXXXXXXXXXXXXXXXXXXXXXXXXXXXXXXXXXXXXXXXXXXXXXXXXXXXXXXXXXXXXXXXXXXXXXXXXXXXXXXXXXXXXXXXXXX
