--------------------------------------------------------------------------------------------------------------------------------------------------------------------------------------------------------
-----------------------------------------------------------------------------------------------------------------------------------------------------------------------------------------------o--------
--------------------------------------------------------------------------------------------------------------------------------------------------------------------------------------------------------
------------------------------------------------------------------------------------------------------------------------------------------------X-----------------o-------------------------------------
--------------------------------------------------------------------------------------------------------------------------------------------------------------------------------------------------------
-------------------------------------------------------------------------------------------------------------------------------------------------------------------?------------------o-----------------
--------------------------------------o--------------------------------------------------------o------------------------------------------------------------------------------------------------o-------
-o-----------------------------------------------------------------------------------------------------------------------------------------------------------------------------------------------------v
---------------------------------------------------------o-----------------------------------------XXXXXXT--------XXXXXXXX------XXXXXXX----XXXXXXX-----------------------------------------------------f
------B----------------------XXXXXXXX-------------------------------X---------T---------XXXXX-----------X|---------------------XXXXX-------------------------------------------------------------------f
-----------------------------------------------------?X?----------------------|-----------XXXXXX---------|----------------------XXXXX------------------------------------------------------------------f
-------------------------------------------------------XXXX-------------------|?---------------------XXXX|---------------------------------------------------------------------------------------------f
--B----------------------------------------X-------------o-----T--------------|-------------------------X|-----------------------------------------------------------X-------------------------------X-f
-----------------------------------------------o---------------|-------------X|X-----????????------------|--------------------XXXXXX---XXX-------------------------------------------------------------f
m--------------------------------------------------------------|--------------|--------------------------|----------------------------------E------------------------------E---------------------------X
XXXXXXXXXXXXXXXXXXXXXXXXXXXXXXXXXXXXXXXXXXXXXXXXXXXXXXXXXXXXXXXXXXXXXXXXXXXXXXXXXXXXXXXXXXXXXXXXXXXXXXXXXXXXXXXXXXXXXXXXXXXXXXXXXXXXXXXXXXXXXXXXXXXXXXXXXXXXXXXXXXXXXXXXXXXXXXXXXXXXXXXXXXXXXXXXXXXXXXXX
