-----------------------------------------------------------------------------------------------------------------------------------------------------------------------------------------------------------
----------------------------------------------B--------------------------------o------------------------o----------------------?---------------------o-------------------------o-----------------o---o-----
-----X--------------------------o----o-----o--------------------------------------------------------------------------------------------------------------------------------o-------o-o--------------------
-------------------------------------------------o--------?--------------------------X-----------o---o---------------------o-------------------------------------------------------------------------?-----
------------------------o-------X--------------------Xo-----B-------------o------------------------------------------------------o---------------------------oo--------------------------------------------
-------------?-----------------------?--o------------------------------oB------------------------------------------------BBBXBB----o--------------------------B---------------X-------------?--------------
--X-------o----X-----------------X----X---------o---------------------------------------------?---------------?----------------------------------------X-----------X-----------------------o-o-------------
--------------------------------------------------o----?------------------X----------------------------------X---------XXXXXXX-----------------------------------------------B---------------------o--ov---
--------------------------------------------?XXX--------------------o--------------------------o----------------------T----------------X----------T---------------o----------------o-------------------f---
---X--------------------------------------------X-o--------------o------------------o-------------------T---------o---|o--------------------------|-----------------o--------X-------------------------f---
---------------X-------------------------X---------------------------oo----------------------------T----|-----T-------|---------------------------|--T--T-T----T----------------------------o----------f---
------------------BBBBB---------T---------XXB--o---XXXXXXX--B------------------T--B---------XXXXX--|--BX|XBBB-|------BT------o-------------------B|--|--|-|-T--|----o-Xo---------------o---------------f---
-------------------------------o|---oT-----------------------------------------|-TT---o----------o-|----|-----|------o|-----------X---T-----------|-T|--|T|-|o-|---------------------------------------f---
-----------------o--------------|----|----------------?-------------------o----|-||-----------X----|----|-----|-------|---------------|-----------|-||--|||-|--|----------------X-----------o----------f---
m------------------E------------|----|--------------------------E--------------|-||----------------|----|-----|-------|---------------|-----------|-||--|||-|--|--------------------E-E----------------X---
XXXXXXXXXXXXXXXXXXXXXXXXXXXXXXXXXXXXXXXXXXXXXXXXXXXXXXXXXXXXXXXXXXXXXXXXXXXXXXXXXXXXXXXXXXXXXXXXXXXXXXXXXXXXXXXXXXXXXXXXXXXXXXXXXXXXXXXXXXXXXXXXXXXXXXXXXXXXXXXXXXXXXXXXXXXXXXXXXXXXXXXXXXXXXXXXXXXXXXXXXXX
