--------------------------------------------------------------------------------------------------------------------------------------------------------------------------------------------------------
--------------------------------------------------------------------------------X--o--------------------------------------------------------------------------------------------------------------------
-------------------------X----------------------------------------------------------------------------------o------------------------o------------------------------------------------------------------
--------------------------------------------------------------------------------------------o-----------------------------------------------------------------------------------------------------------
--------------------------------------------------------------------------------------------------------------------------------------------------------------------------------------------------------
--------------------------------------------------------------------------------------------------------------------------------------------------------------------------------------------------------
---------------------------------------------------------------?----------------------------------------------------------------------------------------------------------------------------------------
---------------------------------------------------------X------------------------------------------------------------o------------------------?--------------------?----------------------------o-----v
-----------------o---------------------------------------------------------------------------------------------XXXX----------X-------------------------------------------------------------------------f
-------------------------------X------------------------------------------XXXXXXXX--------------------------------------------XXX----------------------------------------------------------------------f
-----------------------------X-X-X---------------------B----------------------------------------------BBBBBBB-----------------------------------------B-BBB--------------o-----------------------------f
----------------------------------------XX-----------------------------------------------------XXXXXBXT--------------------X---BB--B----------------------------------------------o----------------o---f
-------------------------B------o---------o-----XX--XX--------------------XXXX------------------------|-----------------------------------------T-----------------------------------------------o------f
------------------------------o--------------------------------------------B--XBB-B--B------X---------|-----------------------------------------|------------o-----------------------------------------f
m-------------E-------E--E--------------------------------------------------E-------------------------|-----------------------------------------|-------------E---------------E-E--E-------------------X
XXXXXXXXXXXXXXXXXXXXXXXXXXXXXXXXXXXXXXXXXXXXXXXXXXXXXXXXXXXXXXXXXXXXXXXXXXXXXXXXXXXXXXXXXXXXXXXXXXXXXXXXXXXXXXXXXXXXXXXXXXXXXXXXXXXXXXXXXXXXXXXXXXXXXXXXXXXXXXXXXXXXXXXXXXXXXXXXXXXXXXXXXXXXXXXXXXXXXXXX
