--------------------------------------------------------------------------------------------------------------------------------------------------------------------------------------------------------------
-----------------------------------------------------------------------------------------------------------o-o----------o--o--o-------------------------------------------------------?-----------------------
---------------------------------------------X--------------------------X----------------B----------------------o-------------------------------------------------------------------------------o-------------
-----------?----------------------------o----------------------------------X--------------------------------------------------------------------X----------------------------X-------o----------o-------------
--------B---------------------------------------------X----X----o-------------------o-----------------------o-------------------------------------------X----o------------------------------------------------
--------------B--------------X-------o--------------------------------X------------B-----B-----o---------------B---------o----------------------?------------------o----------X-------------------------------
---------------o---o-----------------------------X--------------------------------o----------------o----------------------------------------------------------------o---------o-------------------------------
------------------------o-----------------------?--o-o--------X--------------------------------------------------------------o------------------o---o--------------------------------------------------v------
------o--------------X--------o--XX-------T-----------------------------------?-????-------XXX---XXX------XXXX--------------X-------------------------------XXBXXX----------------?--------------------f------
----------------------------------X-------|------------------o-----------------------------------------------------------------------------------XXXX--------------------------------------------------f------
-----o------------------------------o-----|---------------------------------------------------BBX--BBBBB----------------------------------------o----------X-------------------------------------------f------
-----o------------o-----o-XXX-------------|-----o-------------------------------------o-------XXXXXXX-------o---XXXXXXXXX-------------XXXXX?XX--------------XXX----------XXX---------------------------f------
-------------------------------------o---?|XXX----------------------------X-----------------------------------------------------------------------------------------------------------o-------X--------f------
--------------------------------o---------|------------------------------------------------------------------------------------X---o-------------------------------------------------------------------f------
m-----------------------------------------|--------------------------------------------------------------E---------------------------E---E--------E---------------------------------E------------------X------
XXXXXXXXXXXXXXXXXXXXXXXXXXXXXXXXXXXXXXXXXXXXXXXXXXXXXXXXXXXXXXXXXXXXXXXXXXXXXXXXXXXXXXXXXXXXXXXXXXXXXXXXXXXXXXXXXXXXXXXXXXXXXXXXXXXXXXXXXXXXXXXXXXXXXXXXXXXXXXXXXXXXXXXXXXXXXXXXXXXXXXXXXXXXXXXXXXXXXXXXXXXXXX
