-----------------------------------------------------------------------------------------------------------------------------------------------------------------------------------------------------------
--------o----------o--------------o--------------------------oB--------------------------------------------------------------------------------------------------------X-----------------------o--B--------
-----------------------------------------------------------------------------------------------------------------------------------------------------------------------------------------------------------
----------------------------------------------------------?------------------------------------------------------------------------------------------------------------------------------------------------
----------------------------------------X-------------------o--------------------------------------------------------E----------------------------------------------------------o--------------------------
--------------------------------------------o---------------------------------------------------o----------BBB-BBXBBBBB-------o-------------o---------------------------------X-----------------------o----
---o----------------------------------------------------------------------------o----------------------------------X--------------------o-------------------------------------------------o----------------
-----------------------X-----------------------------------X-------------------------------------------o--------------------X---B?BBBB----------------------------o----------------------------o----o--v---
----------------------------------------------------------------o----------------------------------------------------------------------o--------------------------------------------------------o------f---
--------------------------------X----------------------------------------------------------------------BBB-XBBBB--------------------------------------XXXXX----------------X---------------------------f---
-----------------------------------T--------o----------------------T-----------------------------------------------------------------------------------B-----------------------------------------------f---
--------------------o-----BBB---BBB|BBB---BBB---------------XXXXXXX|--------BXXXX----BXBBBBBB------X-?XX????-----B-B--BBB-----BBBBBXBB--------X------------------------------------o------------------of---
--------X-------o------------------|-----o-------------T-----------|------T---------------T-----------------------------------------------------------------------------------------------------?------f---
-----------------o-----------------|-----------?-------|-----------|------|---------------|------------------------X--------------------o--------------------------------------------------------------f---
m-E-----E-------------------------E|--------E----------|-----------|------|---------------|-------------------------------------E----------------------------------------------------------------------X---
XXXXXXXXXXXXXXXXXXXXXXXXXXXXXXXXXXXXXXXXXXXXXXXXXXXXXXXXXXXXXXXXXXXXXXXXXXXXXXXXXXXXXXXXXXXXXXXXXXXXXXXXXXXXXXXXXXXXXXXXXXXXXXXXXXXXXXXXXXXXXXXXXXXXXXXXXXXXXXXXXXXXXXXXXXXXXXXXXXXXXXXXXXXXXXXXXXXXXXXXXXX
