-?-o-----T-E---E-----|--?-----M-|--B-B------B-M----|M-|---E----o----B-T?----?--T-------------X------|----X----B-----|-T---B--------??-T--E--T------o-?------X|-------M|----EE--M-----T------o--B--o-M|M-
------------B--------------------B--o-XBo------?-E-----E------B-T-----X---ME---B-o-?----------?M-o-B-X--------M-------Eo------M-------------o-X-----E------B---?------------E----E---|-----B--o---X-----
-----o------------|X-----E---BM---------X?T--|XB-------o--|--M------BT-B----|-B---|-------|X-oM-MT-------E---------?---TB-o---o--o---------M----?--|---T-E---?-----?X--------B-----TM?----T--ooE----TT--
----------TE--|----------E-T------------T------ME----------?--MX----M-T-------B|-Xo-o--X-----|?----X-??----BE--E----?---EX---EXX-------X----X----------To-X------------------M-B--X--E-----E----o-------
-oT----|----B-M----X--------oM--------------oo|---E----E-o-------X-B-------o-------X-X-X-E---|E----M--M-|M-|T--?----|-E--E----o------X-E-E|-----X-----------------M-B-XMX-M-|---E-------------?------T--
------XBB|--E-?E----X-o-------?-E---M--??--X---|---?---B------X---B--M----M-?--X------------|--?-----------oE------|---|-BB------o-----T--TE----E--M-|XT---|-------X---?-------?-----X|-?-T---X---T---B-
----|-o-----X|--?----------------o|---------??M-oo--EB---------------M-B--------o---------|---B---|-B-----EMX-T---------------B-M-----X-----M---------------EBM---B---TX------B---o-------B---------X---
-|E-----E---X--------XM-B--|--ME---B-------M--------------MX--X--X--XM----oE--------------TEE-B--|-?--?--B-------|----------B-------X---|-?---o-XT-|--|---?---BE----B------TT------T--B---E-------X-M--v
-B-X-------XT-o-|-----Xo--M--M--|-|EM--o------E-----B-M?--E---M-?-TE---X--E-----?--M---T--XB-oX------X-----E------o--X--E-------B----B-X--E-----|--------?M?-------X-M---M---oX---E------------------E-f
---oo------E-o----X--------------?---o-------|-----E-----X--|-|X---B-------|-E----?--M---------|--?--?-----?---------------------E------M|-M----MM--X-----X---|------T---?-----------M---ET---o-----X--f
---|----o-M---EM----|----|-?-T--B----|--------T----|o-BB-EE-----Bo--X-B------M-----o-B--M-----|------BE--o---X?--|-T--E----------?-------E----------T------X-M?ET-----BETT----TMT|-ME---T--X---?-TB--B-f
---?X--|--o---T--o-B---X--X----M----X-B---oo--E---M---???----oo-----E?-|----------------|E-------?XX-|--?----|---o--|----E----B-------T|T|---?X-X-oM----------|---B-||---|X------|o-------|--TB------|-f
------BE-----o|-----M---B---X-?--------?----------?--?-----?M---o?----T--|--------?-|o--M-MB-o--E-------E---E--------------------X-M--------|---E-----------E|o-M--------M--X-T----------o-T-----TTE-|Tf
----T-----o-B---?--------E--------TT---M--T------E-E--------------o---------M-B--o--?-?-M---E----E----------B|-X-o-------B----?|--EE--X--B--E--XT--|M?--|-X---o---X-o-----X-MT-------B-XE-E--M?--------f
m------------------------------------------------------------------------------------------------------------------------------------------------------------------------------------------------------X
XXXXXXXXXXXXXXXXXXXXXXXXXXXXXXXXXXXXXXXXXXXXXXXXXXXXXXXXXXXXXXXXXXXXXXXXXXXXXXXXXXXXXXXXXXXXXXXXXXXXXXXXXXXXXXXXXXXXXXXXXXXXXXXXXXXXXXXXXXXXXXXXXXXXXXXXXXXXXXXXXXXXXXXXXXXXXXXXXXXXXXXXXXXXXXXXXXXXXXXX
