-----------------------------------------------------------------------------------------------------------------------------------------------------------------------------------------------------------
-------------------------------------------------------------------B-----o---------------------------------------o---------------------------o---------------------------------------------------X---------
----------------------------------------------------------------------------------------------------------------------------------------------------o------------------------------------------------------
---------o-----------o--------------------------------------------------------------X------------------------------------------------------------------------?---------------------------------------------
------------o-----------------------X-------------o---------------------------o-------------------------------------------------------------------------------------------o--------------------------------
--------o-----------------------------------------------X----------------------------------------oX--------------------------------------------------------------------------------------------------------
-------------------------------X---------------o-------------------------------------------------------------------------------B--------------------------------------------------o------------------------
-----------------------------------------------------------------------------B----------------------------------------------------------------------------------------------------------------o--------v---
--------------------XXXX------X------------XXX-------XXXXXXX-------------------------------------------------------------X-----------o---------o-------XXXXXX------------------------------------------f---
----o------------------------------X--------------XXXXXXX-o---------------------------------------XXXX-------------------------o--------------T---o-------------------------------o--------------------f---
-----------------------------------------------------XXX-XXX-------------------XXXXXX----------------------------------XXXXXXXX------o--------|-------------------------------------X------------------f---
---------------------------------------------------------XXXXXXX------------------------------------------------------------------------------|---------X--------------------X-------------------------f---
-------------------BBBBBBBT------------------------------X------------o-o--------------------------------?-----B-----------------------------X|XXXX--T-----------------------------------o--o----------f---
--------------------------|XXXX----------?????-----o--B-----------------------XXXo--------XXXXXXX-----------XXXXXX-------------------o--------|------|-------------------------------------------------f---
m------------EE-----------|-------------------------------------E-----------------------------------------------------------------------------|------|-------------------------------------------------X---
XXXXXXXXXXXXXXXXXXXXXXXXXXXXXXXXXXXXXXXXXXXXXXXXXXXXXXXXXXXXXXXXXXXXXXXXXXXXXXXXXXXXXXXXXXXXXXXXXXXXXXXXXXXXXXXXXXXXXXXXXXXXXXXXXXXXXXXXXXXXXXXXXXXXXXXXXXXXXXXXXXXXXXXXXXXXXXXXXXXXXXXXXXXXXXXXXXXXXXXXXXX
