-----------------------------------------------------------------------------------------------------------------------------------------------------------------------------------------------------------
-----------------------------------------------------------------------------o-------------------o---------------------------------------------------------------------------------------------------------
----------------------------------------------------------------------------------------------------------------------X------------------------------------------------------------------------------------
-----------------------------------------------------------------------------------------------------------------------------------------------------------------------------------------------------------
----------o------------------------------------------------------------------------------------------------------------------------------------------------------------------------------------------------
---------------------------------------------------------------------------------------------------------------o-------------?-----------------X-----------------------------------------------------------
--------------------------------------------------------------------------------------------------------------------o------------o-------------------------------------------------------------------------
--------------------------------------------------------------------------------------------------------------------------------------------o----------------------------------------------------------v---
---------X-------------------------------XXXXXXX----------------------------o--------------------------------------------XXXXXXXX--BBB------------------X-----------------------------------------o----f---
------------------------------------XXXXXX-----------------------------------o------------oXXXXXXX--XXXXXXX----------------------------------------------------------------------o----o----------------f---
----------------------------------------X------------------------------------BBBBBBBB-----------------------XXXXXXXX---XX-----------------------o----------XX-XXXX-------------------------------------f---
--------------------------------------------------------T--------------------------XXXXXX--------------------------------o----------------o-----XXXX---------------------------------------------------f---
------------------------------------T--------XXXX-------|----------------------------------------------------------------------------T-----------------------------------------------------------------f---
-----------------------------XXXXXXX|-------------------|-----------??X????BBBBBBBB------------------------XXXXXX--------------------|-------------o---------------------------------------------------f---
m-E---------------------------------|-------------------|------------------------E-----------------------------------------------E---|-----------------------------------------o-----------------------X---
XXXXXXXXXXXXXXXXXXXXXXXXXXXXXXXXXXXXXXXXXXXXXXXXXXXXXXXXXXXXXXXXXXXXXXXXXXXXXXXXXXXXXXXXXXXXXXXXXXXXXXXXXXXXXXXXXXXXXXXXXXXXXXXXXXXXXXXXXXXXXXXXXXXXXXXXXXXXXXXXXXXXXXXXXXXXXXXXXXXXXXXXXXXXXXXXXXXXXXXXXXX

