-----------------------------------------------------------------------------------------------------------------------------------------------------------------------------------------------------------
---------------------o-------------------------------------------------------------------------------------------------------------------------------------------------------------------------------------
-------------------------------------------------------------------o-o--------------------------------------------o--------------B--o--o------------------------------------------------o------------------
--------------------------------------------------------------?----------------------------X----------------------------------------------------------------------o----------------------------------------
----------------X----------o---------------B-o---------------------------?---------------------------------------------------------------X---------------------------------------------X-------------------
----------------------o-------?------X--------------?????--------------------------------------------------X---------?--o------------------o---------------------------------------------------------------
-o------------------------------------o---o------------o-----X-o---------------------XX--------------------------------------o----------------X-------------------------------B----------------------------
-----------------------------oo--------------o-------------------------X----o--------------------------------------------------------X------------XXX----------------------------------------------X---v---
-----------?-----------------------o------------------------------------------------X--------o----------X-----o----------------------------------------------X--o--------------------------------------f---
--------------------------------------------------XXXX-------------X------------------------o---------------------XXXXXX--------??-----X-o-------B------------------o-------X----------------X---------f---
---------o--------------------o-------------------------------------------------------o--------------------------------------------X--o-------------------------------------------------------o-------of---
------------XX----XXXX-----------XXX------------XXX-------T-XXX------XX??XXXXX------------XXXX----o----XXXX---XXXXXXX?X--------X-o-----XXX--------XBX?XXXXXX-------------------------------------------f---
----------------------------------------------------------|----------------o------------T-------------------------------------------------T------o-----oo----------------------?o----------------------f---
----------------------------------X-----------------------|-----------------------------|---------------o------------------------------o--|------------------o-------------o--o-----------------o------f---
m-E--------E---E------------------------------------------|-----------------------------|-----------------------E----------------E--------|------------------------------------------------------------X---
XXXXXXXXXXXXXXXXXXXXXXXXXXXXXXXXXXXXXXXXXXXXXXXXXXXXXXXXXXXXXXXXXXXXXXXXXXXXXXXXXXXXXXXXXXXXXXXXXXXXXXXXXXXXXXXXXXXXXXXXXXXXXXXXXXXXXXXXXXXXXXXXXXXXXXXXXXXXXXXXXXXXXXXXXXXXXXXXXXXXXXXXXXXXXXXXXXXXXXXXXXX
