-----------------------------------------------------------------------------------------------------------------------------------------------------------------------------------------------------------
-----------------------------------------------------------------------------------------------------------------------------------------------------------------------------------------------------------
-------------------------------------------------------------------------------------------o-------------------------------------------------------------------o--------------------------------------o----
-------------------------------------------------------o--------------------------------------------------------------------------------------X------------------------------------------------------------
-----------------------------------------------------------------------------------------------------------------------------------------------------------------------------X-----------------------------
----------------------------------------------------------------------------------------------o--o--------------------------------------------o---------------------------------------o-------o------------
-----------------------------------------------------------------------------------------------------------------------------------------------------------------------------------------------------------
--------------------------------------------------o-----------------------------------------------------------------------------------------B----------------------------------------------------------v---
------------------------------------------------------------XXX----XXX--------XXXXXXXXXXXXX----------------------XXXXXX----------XXX-------XXX--------------------------------o------------------------f---
-------------------------------------------------------------------------------------XXX----XXXXXX---------------------------o-------------------------------------------------------------------------f---
----------------------XXXXXX---------------------------------------------------------------------------XXXXXXXX---XXXXXXX-----------------T------------------------------------------------------------f---
-------------o-------o--XXXXXXXX------------------------------------------------------------------------XXX---------------------XXXXXX----|-----------------------------X------------------------------f---
--------------------------XXXX---------------------XXXXXXXX-o---X-o-------------XXXXXX----------------------------------------------------|------------------------------------------------------------f---
----------------------------XXXX----------------------------------------o-----------------------------------------------------------------|------------------------------------------------------------f---
m-E------------------------------------------------E--------------------------------------------------------------------------------------|----------------o----------E--------------o-----------------X---
XXXXXXXXXXXXXXXXXXXXXXXXXXXXXXXXXXXXXXXXXXXXXXXXXXXXXXXXXXXXXXXXXXXXXXXXXXXXXXXXXXXXXXXXXXXXXXXXXXXXXXXXXXXXXXXXXXXXXXXXXXXXXXXXXXXXXXXXXXXXXXXXXXXXXXXXXXXXXXXXXXXXXXXXXXXXXXXXXXXXXXXXXXXXXXXXXXXXXXXXXXX

