-----------------------------------------------------------------------------------------------------------------------------------------------------------------------------------------------------------
-------------------o-------------------------------------------------------------------------------------------------------o------------------------------------------?X-----------------------o-----------
------------------o----------------------------------------------------------------------------------------------------------------------------------------------------------------------------------------
----------------------------------Xo-----------------------------------------------------------------------------------------------------------------------------------------------------------------------
----------------------------------------X-------------------o---------------X----------------------------------------E----------------------------------------------------------o------o---o---------------
------------------------------------------------------------------------o----------------------------------BBX-BBXBBBBB-------o-------------o---------------------------------X----------------------------
--------------o-------------------------------o--------------------------------------------------------------------X--------------------------------?---------------?---------------------o----------------
---------------------------------------?B---------------------------------------------------------------------------------------B?BBBB-----------------------------------------------------------------v---
---------o-----------------------------------------------------------------------------------------------------------o------------------------------------------o-------------------------------o------f---
------------------------------------------------------X------------------------------------------------BBB-BBBXB------o-------------------------------XXXXX--------------------------------------------f---
-------------------o---------------T-------------------------------T-----------------------------------------------------------------------------------?-------------------------------------o---------f---
--------------------------BBB---BBB|BBB---BB?---------------XXXX?XX|--------XXXXX----BBBBBXBB--------???????-----XBB--BXB-----BBBBBXBB----------------------------------------------------------------of---
-----------------------------------|-----o-------------T-----------|------T---------------T------------------------------------------------------------------X----------------------------------?------f---
---o-------------o-----------------|-------------------|-----------|------|---------------|-----------------------------X------------------------------------------------------------------------------f---
m-E-------------------------------E|--------E----------|-----------|------|---------------|-------------------------------------E----------------------------------------------------------------------X---
XXXXXXXXXXXXXXXXXXXXXXXXXXXXXXXXXXXXXXXXXXXXXXXXXXXXXXXXXXXXXXXXXXXXXXXXXXXXXXXXXXXXXXXXXXXXXXXXXXXXXXXXXXXXXXXXXXXXXXXXXXXXXXXXXXXXXXXXXXXXXXXXXXXXXXXXXXXXXXXXXXXXXXXXXXXXXXXXXXXXXXXXXXXXXXXXXXXXXXXXXXX
