-----------------------------------------------------------------------------------------------------------------------------------------------------------------------------------------------------------
---o------------------------------------------------------------------------------------------------------------------------B------------------------------------------------------------------------------
----------------------------------------------o----o-------------------------------------------------------------------------------------------------------------------------------------------------------
---------------------------------------------------------------------------------------------------------------------------------o---------------------------------------------------------------?---------
-------------o-----------------------------------------------------------------------o---------------------------------------------------------------------------------------------------------------------
--------------------------------------------------------------------------------------------------------------------------------------------------------------------------?--------------------------------
------------------------------X-X-----------------------------------------------------------------------------------------------------?----------o------------X------------------o-------------------------
----B-----------------------------X---------------------o--------------------------o----E-----------------------------------------------------------X--------------------------------------------------v---
-----------------------------------------------------------o--o---------------o---XXXXXXXX---------------------------------XXXXX----------X------------------------------o-----------------------------f---
---------------------BBBB-------------------XXXXBBBB-----------------------------------------------------XXXXXXX-------------------------o?????-------------------------X------------------------------f---
-----------------------------------------?----------------------------------------------T----------------XXXXXX--------------------------------o-------------------------------------------------------f---
-X------------------------------------------------o--------------XXXXX------------------|-------T----------------------XXXX---------------------------------o---------------------------X--------------f---
-----------------------------T----------------------------------------o-------XX?XX?X---|-------|---------------------------------------------------------------XXX-------------------------oo---------f---
-----------------------------|-----XXXXXX-------------------XXXX------------------------|-------|----------------------------X---------------------------------XXXXXXXX---o----------------------------f---
m----------------------------|-------------E--------------------------------------------|-------|------------------------------------------------------------------------------------------------------X---
XXXXXXXXXXXXXXXXXXXXXXXXXXXXXXXXXXXXXXXXXXXXXXXXXXXXXXXXXXXXXXXXXXXXXXXXXXXXXXXXXXXXXXXXXXXXXXXXXXXXXXXXXXXXXXXXXXXXXXXXXXXXXXXXXXXXXXXXXXXXXXXXXXXXXXXXXXXXXXXXXXXXXXXXXXXXXXXXXXXXXXXXXXXXXXXXXXXXXXXXXXX
