T-------E------M---------?EE---B----?--o--B-?----T-o--------M-----BE---M--?X--o----|--------------B--M---EM-------E?---B----?---------T?E------B-oX-BM-----E-T-----?----------------T----?--------T----M
X----E---------XT------X--------?-?------?------?o----------X----------M----E------??------X-?-|----E--o--------E----------o--M------M-M-|-----EM--B-----XEX--------X------------B-------EB------------B
MT-M--T--B----------------oXT-------------------ET-BE----T--o---M--XX---T|---?---------M--|---------X-E------|---?------T-|-------ME-------E-----oB--M-|E--M---X|---B-----------o------E|XM---------B--?
-X-B----E-------|------B-M--------------T-----?----------BX?--E-M------oB-X-B--B-------X-------M--E-TT-MX--B-X-----T----M--Eo-|--B--o---E--|--|X-----TB-------oM----E--|-T------o-T----T---------E---|TT
o-o----E|?-MXT---------?|--T-MT--B----E-?T-----?-oB----------?---?-----MoT-|-------|-T----B---?B?E---------MBT-XT-M----?------------M-----Xo----X---M-------XM--T---X-----X------oT--o-----------------|
T----o--o--------BM---------M--------|-T--M-----M-----------------|-------o--E--oM-------B---------X--?T------E-----o---|---T-B----------o---?------B-TX--TE-------?--M------B----E--E---E|--T-?-------M
B--------T--?-------?-----T-----XTX-------X---------E--E----XE-o------X----EM----B--X-|------B--BX-B-B--M---T---E----o-----B--------T--E-----MX---o-T-?--------?ME--|-B-----E?-----T--X--------o-To--?MM
T--X---X---?---X---E---------------------?---------E--------------------------------ME-MM-----T--------?-oE-T-o-o-?Mo-M--BE--?-------o---?----?----o---|-M---o--TE--?-B----X-?X-?----o--X---BB-E--|?--ov
T---|-----------MT----|-------E---M----?|---?-----B-M-----X--|---?-?E---------?----o------X--------X-|o----T--?-o--E-M-----o-X----o--TTB---E-o--o----------------T--------T-----T-|----T-------|-------f
-----B-----------T-E-------?---T----X|--o---M-------|B-TXooo---------||E-oE-?-?--M-MB-BB-----X-X-------|o----X----B---?--------E-TT----o--X-o--|---XB-M-----XT--EB-----------|-----T-M--X--BoTB-?-XE--Bf
M?--o----o------B---|----To-o----X---X---------|-o--B-M----M--?------------B-----||------------|--T-o---|----|M--B-----------E-o---------------------E-----B----------?--MB---X--T--------------?------f
B---T----X-X---|X------EE----------T?--B-?-?---oE------------M-E----M---BT--MoE---------M?-----E--|-----?----E---?-----E----------------o----|-To----Mo----o--XE-?------------o-E---B-X---------|M-----f
o-----T|-------E-|-TM--E-E---EE-o?o-----o----E--------?TE--X-T---|----------T-|--B------MT---o-----X-------------o---B--E---TM-o---X-M-----B-T-----o--|----------EB-----?-----------------------?|B--?|f
XM--E--ToB-TMB-B----------X-----M-?---|---T-M--------B---M--|------o--T--o-T?---------E-M--E-o------E?-X----------M-XEB---o---T----------T-B-|---M---E-----------X-o----M--B------TM--|-MX--|-Eo-B----Tf
m------TT------BT------M-E-|------X---------|-?---M---T-------?T--M-o---E---|?-----E------M-----X----------X------|---|-----o-X---B----E---o---|--?----|-----T?-------B---?--------------EMM--M----?-M-X
XXXXXXXXXXXXXXXXXXXXXXXXXXXXXXXXXXXXXXXXXXXXXXXXXXXXXXXXXXXXXXXXXXXXXXXXXXXXXXXXXXXXXXXXXXXXXXXXXXXXXXXXXTXXXXXXXXXXXXXXXXXXXXXXXXXXXXXXXXXXXXXXXXXXXXXXXXXXXXXXXXXXXXXXXXXXXXXXXXXXXXXXXXXXXXXXXXXXXXXX
