-----------------------------------------------------------------------------------------------------------------------------------------------------------------------------------------------------------
-------o--------------------------------------------o----------------------?-----------o--------------X------------------o------------o----------------------------------o---------------------------------
------------------------------------------------------o--o--------o-------------------------------------------------------------------------------------------------------o--------------------------------
-------------?------------o----------------------------------o----------------------------------------X-----------------o-----B------------------B----------X----------------------------------------------
------------------o------------oX---------o-------------o----------o--------------------------BB--o--------o------------------------o-o---------------------------------o---------------o------------------
-------------?o---o--------------------------------------------------------------------------------------o-o--------------------B------------------?-----------------B-----------------------o-o-----------
---------------X--------------------?----?-----------o----------B-----------------------------------------------X--------------------X-----------------------------------------------B------------o--------
----------------------------------o-----------------------o----------------------------B-------B----?-----------------------------BXB----o--------------------o----------------------------------o-----v---
--------------------------------------------------X-------B------------BXBB-----------------BBX--------------------------T------?---------XB-------------------------------X------X---------o----------f---
---X-----------------------------?o-------------------------------X------------------------------------------------------|-------------------BBB-------o-----------B--------------------o--o-----------f---
--------o------X---------?------------------------------------T--------?-----T---------------T-----X--------T-----T--?---|--------T-------------------o---------------o-----------------------o--------f---
---------------------BB-----BBB-T-------T---B----------------B|BBB---????----|-----?BB----B?B|------------BB|BTB--|------|X--BBBBB|Bo---BBB----------BBBX-XBB-T-----------------------------o-X----o---f---
----------------------------?-oo|-------|-------------------?-|--------------|-----o---------|-T--TX--------|o|---|TT----|--oT--T-|-----T---------------------|------------o-o-------------------------f---
--------------------------------|-------|---------------------|-----o----o---|---------------|-|--|---------|-|---|||----|---|--|-|-----|---------------------|o--------------------------------o-o----f---
m----------------------------E--|-------|---------------------|-E-----------E|---------------|-|--|---------|-|---|||----|---|--|-|-----|---------------------|-----E----------------------------------X---
XXXXXXXXXXXXXXXXXXXXXXXXXXXXXXXXXXXXXXXXXXXXXXXXXXXXXXXXXXXXXXXXXXXXXXXXXXXXXXXXXXXXXXXXXXXXXXXXXXXXXXXXXXXXXXXXXXXXXXXXXXXXXXXXXXXXXXXXXXXXXXXXXXXXXXXXXXXXXXXXXXXXXXXXXXXXXXXXXXXXXXXXXXXXXXXXXXXXXXXXXXX
