-----------------------------------------------------------------------------------------------------------------------------------------------------------------------------------------------------------
-----------------------------------------------------------------------------------------------------------------------------------------------------------------------------------------------------------
----------------o------------------------------------------------------------------------------------------------------------------------------------------------------------------------------------------
----------------------------------------------------------------------------o---------------o------------------------------X------------------------o----X-------------------------------------------------
------------------------------------------------------------------------------------------------------o----------------------------------------------------------------------------------------------------
-----------------------------------------------------------------------------------------------------------------------------------------------------------------------------------------------------------
----------------------------------------------------------o-----------------------------------o------------------------------------------------------------------------------------------------------------
-------------------------------------------------------------------------------------------------------------------------------------------------------------------------------------------------------v---
--------------------------------------------------X----X---------------------------XXX-------------??????----------------------------------------------------------------------------------------------f---
-------------------------------------XXXX--------------XXXXX-------------------o-------------------------------------------------------------------------------XXXXXXXX--------------------------------f---
------------------------------------------------------------------XXXXX-------------BBBBBB-B-XXXX-------------------------o----------------------------------------------------------o-----------------f---
--------------------XXX----------------------XXXXX?---------XXXXXX----------------------------------------????????----------------?---------------------??????-----------------------------------------f---
-------------------------------------------------------------------------------------------------------XXXTXXXX--------------------------T--o----------------o-----------------------------------------f---
-----------------------------------------------------------------XXX-----XXXXXX---------------------------|------------------------------|-------------------------------------------------------------f---
m-EE------------------------------------------------o---------------------E-----------E-------------------|------------------E-----------|-------------------------------------------------------------X---
XXXXXXXXXXXXXXXXXXXXXXXXXXXXXXXXXXXXXXXXXXXXXXXXXXXXXXXXXXXXXXXXXXXXXXXXXXXXXXXXXXXXXXXXXXXXXXXXXXXXXXXXXXXXXXXXXXXXXXXXXXXXXXXXXXXXXXXXXXXXXXXXXXXXXXXXXXXXXXXXXXXXXXXXXXXXXXXXXXXXXXXXXXXXXXXXXXXXXXXXXXX
