-----------------------------------------------------------------------------------------------------------------------------------------------------------------------------------------------------------
-------------------------?----------------------------------------------------------X----------o-----------------------------------------------------------------------------------------X-----------------
----------o---------------------------------------------------?--o---------X------o-------------------o------------------------------------------------------------o---------------------------------------
--------------------X---------------------------o----------------------------------------------------------------------------------------------------------------------------------------?-----------------
----------X--------------------------------------o-------------------------------------------BXX--BX----------------------------------------------------X--------o---X-------------------------------------
-----------------------------o--------X------X-------o-----------o---------------------X------------------o-------------X---?--X-o-----------X---?---------------B---o-----o-------------------------X-----
--------------X?----------X---------------------X-X-------X---------------------------------------o----------------------o-----------------------------o--------------------?----------------?--o----------
--------XX--------------------------o-o------------------------------------------------BBBBBX-B----o-----?----------o-----E----------o----------------X---o?--B----------------------------------------v---
-----------------------------------------------------------------------o--BBBB-BB------------------------------o------??????---------------------------------T---------------------------X-------------f---
--------------------------B------T-------------------------------------------------------------------ooTBXBBBB-----------------------------------------------|---------------X-------------------------f---
-----------o---------------------|--------------------------------------------------o----------------T-|---------------------------------------------------o-|--------------------------------o--------f---
-----------o----o---oT--------B--|BB--o------T---------------XB-BBT-o----Bo------o---XXXXX-----------|B|B?B---------BBBBB-o--------------------T--------o---B|B-------------------------X--------------f---
-----------?---------|-----------|?----------|--?T----------------|----------------------o-o------T--|-|--------------X--------------X---------|---o---------|-----------------------------------------f---
---------------------|---------X-|-----------|---|----------------|----o------B---X-----------o---|--|-|--------------------o------------------|---------o---|------------------------------X----------f---
m--------------------|E----------|----E------|---|----------------|--o---------------E------------|-E|-|---------------------------------------|-------------|--E--------------------------------------X---
XXXXXXXXXXXXXXXXXXXXXXXXXXXXXXXXXXXXXXXXXXXXXXXXXXXXXXXXXXXXXXXXXXXXXXXXXXXXXXXXXXXXXXXXXXXXXXXXXXXXXXXXXXXXXXXXXXXXXXXXXXXXXXXXXXXXXXXXXXXXXXXXXXXXXXXXXXXXXXXXXXXXXXXXXXXXXXXXXXXXXXXXXXXXXXXXXXXXXXXXXXX
