-----------------------------------------------------------------------------------------------------------------------------------------------------------------------------------------------------------
------------------------------------o------------------------------o------------------------------------------------------o--------------------------------------------------------------------------------
----X------------o---------------------------------------------------------------------------------o-----------------o--------------------------------------o---------------------------------o------------
-------------------------o-------------------------------------------------------------------------------------o-------------------------------------------------------------------------------------------
-------------------------------------------------------------------------------------------------------------------o?--------------------------------------------------------------------------------------
---------------------------------------------------------------------------------------------------------X----------------------o------------------------------X------------------X------------------------
---------------------------------------X-----------------------------------------------------------X------------------------------------------------------o--o---------------------------------------------
-------------------------------------------------------o-----------------------------------------------------------o-------------------------o-----------------------------------------------------X---v---
------------------XXXXXX---------------------------------------------------------------------------------------X-XX--X----------------------------XXXXXXX--------------X-------------------------------f---
----------------------------BBB-o--------------------------------------------------------------------------o-----------------X-----------o---XXB-XXXX-BX-----------------------------------------------f---
-----------------------X----------XXXXXX--------------XXT----------------------------------T---XXXXXX-------------XX-X--X------------o----------o------------------------------------------------------f---
-----------------o--------------------------------------|---------------------------?-?----|--------------------------------------------o--XXX-XX------------------------------------------------------f---
-------------------?????X?------------------------------|BBBBBXB----X-XX-------------------|----------------o---------------------------------------------------------------------------------o--------f---
---X--------------------------------?X????-----------XBX|XXX--------X----------------------|---------------o----B--------------------------------------------o---------BB--------------------o---------f---
m-----------------------------E-------------------------|----------------------------------|------E-----E----------------------------------------------------------------------------------------------X---
XXXXXXXXXXXXXXXXXXXXXXXXXXXXXXXXXXXXXXXXXXXXXXXXXXXXXXXXXXXXXXXXXXXXXXXXXXXXXXXXXXXXXXXXXXXXXXXXXXXXXXXXXXXXXXXXXXXXXXXXXXXXXXXXXXXXXXXXXXXXXXXXXXXXXXXXXXXXXXXXXXXXXXXXXXXXXXXXXXXXXXXXXXXXXXXXXXXXXXXXXXX
