-----------------------------------------------------------------------------------------------------------------------------------------------------------------------------------------------------------
-------------------------------------------------------------------------------------------------------------------------------------------------------B------X--------------------------------X-----------
----------------------X------------------------------------------------------------------------------------------------------------------------------------------------------------------------------------
-------X----------o-----------------------------------------------------------------------------------------------------------X----------------------------------------------------------------------------
--------------------------------------------------------------------------------X--------------------------------------------------------o-----------------------------------------------------------------
-----------------------------------------------------------------o------------------------------------------------------X----------------------------------------------------------------------------------
---------------------------------X----------------------------------o-------------------------------------------------------------oo-----------------------------------------------------------------------
-----------------------------------------------o-------------------------------------o-----------------------------------------------------------------------------------------------------------------v---
----------------------------------------------------------------------------------?--------------o---------------X-------------------------------------------------------------------------------------f---
-----------------------------------X-------------------------XXXXXX--------------------T------------------------------------------------------------T--------------------------------------------------f---
-----------------------------------------------o---------------------------------------|--------------------XXX--------o----------------------------|-T------------------------------------------------f---
-------------------------------------------------------------------------------------T-|---------------------------------------------------?---XXXXX|-|------------o-------------------------o---------f---
--------------------------------------------------------------------------o----------|-|------------------------------o-----------------------------|-|----------o-------------------------------------f---
---------------------------XXXXXXXX--------------------------XXXXXX-----------------X|X|X-------------------XXX-------------------------------------|-|---------------X--------------------X-----------f---
m----------------------------------------------------------------------------------E-|-|-----------------------------E-----------------E------------|-|------------------------------------------------X---
XXXXXXXXXXXXXXXXXXXXXXXXXXXXXXXXXXXXXXXXXXXXXXXXXXXXXXXXXXXXXXXXXXXXXXXXXXXXXXXXXXXXXXXXXXXXXXXXXXXXXXXXXXXXXXXXXXXXXXXXXXXXXXXXXXXXXXXXXXXXXXXXXXXXXXXXXXXXXXXXXXXXXXXXXXXXXXXXXXXXXXXXXXXXXXXXXXXXXXXXXXX
