-----------------------------------------------------------------------------------------------------------------------------------------------------------------------------------------------------------
-------------o--------------------------------------------------------------------------------o-------------------------o---------------o------------------------------X-----------------------o-----------
------------------------------------------------------------------------------------------------------------------------------------------------o----------------------------------------------------------
----------------------------------Xo----------------------------o------------------------------X------------------------------------------------------------X----------------------------------------------
----------------------------------------X-------------------o----------------------------o-X-------------------------E----------------------------------------------------------o--------------------------
----------------------------------------------?-----------------------------------------------------o--o---BBB-BBXBBBBB---------------------o-------------------?-----?-------X----------------------------
---o-------------------------------------------o----X-------X------------------------------------------------------X-----------------------------------------------------------X----------o----------------
---------------------------------------?B-------------------------------------------------------------------------------------o-BBBBBB--------------------------o--------------------------------------v---
----------------------------------------------------------------------------------------------------------------------o-----------------------------------------------------------------------------X--f---
-------------------------------------------------------------------------------------------------------BBB-B?BBB--------------------------------------XXXXX--------------------------------------------f---
-----------------------------------T-------------------------------T-----------------------------------------o------------------------------------o---------------------------X------------------------f---
--------------------B-----BBB---BBB|BBB---BB?---------------XXXXXXX|--------XXXXX----BBBBXBBB--------???????-----BBB--BBB-----BBBBBXBB-----------------------o----------------------------------------of---
--------X--------------------------|-----o-------------T-----------|------T---------------T------------------------------------------------------------------X-----------------------------------------f---
-----------------------------------|-------------------|-----------|------|---------------|---------------------------------------------------------o-------------------o------------------------------f---
m-E-----E--------E----------------E|--------E----------|-----------|------|---------------|-------------------------------------E----------------------------------------------------------------------X---
XXXXXXXXXXXXXXXXXXXXXXXXXXXXXXXXXXXXXXXXXXXXXXXXXXXXXXXXXXXXXXXXXXXXXXXXXXXXXXXXXXXXXXXXXXXXXXXXXXXXXXXXXXXXXXXXXXXXXXXXXXXXXXXXXXXXXXXXXXXXXXXXXXXXXXXXXXXXXXXXXXXXXXXXXXXXXXXXXXXXXXXXXXXXXXXXXXXXXXXXXXX
