-----------------------------------------------------------------------------------------------------------------------------------------------------------------------------------------------------------
------------------------------------------?------------------------------------------------------------?------------------------------------------?----------------------------------------------?---------
---------o---------------X-------------------------------------------o-------------------------------------------------------------oo--------------------o---B--------------------------o------------------
-----------------------X------------------o-------------------?----------------------------------------------------------o--------X--------X--------------------------------------------------------B------
----------------X-------------------------------------------------------------X--------------------------X----------------B-----?------------------------------o-----------------------X-------------------
----------------------------------------------------?????-------------------------------------------------------------------------------X---------X-------------------o--------------X---------------------
-o----------------------X--------------------------------------o-----------------------o-------------------------------------------------------------X------------------------B--------------------o-------
--------------X----------------------------------------------------?--oX--------------------?----------------------o---?B-BBB----------------o-----------------------------------X---------------------v---
-----------?--------------------------------------------------------------------------------------------B-------o---------------o---------X-----o-------X------------------------------o-------------o-f---
-------------------------------------------------oXXXX---------------------------------------------------------X--------------o----------B----------------------------------?--------------------------f---
-------------------------------------X-----------------------------------------------------o-----------------------------------------------------------------------------------------------------------f---
-----------XXX----XXXXXXXXX---------------o-----XXX-------T-XXXX-----XBXXX?XXX--------------BBXXX--XXX----T----------BXBBXBBBBB----o-------------------------------------------------------------------f---
----------------------------------------o----------------X|--------o---o-?-o-----------o-X---X------------|------------------o-------------------------------------------------?-----------------------f---
---------------------------o------------------------------|-------------------------------------------o---|--------------------------------o----------B--------------------o--o---------Bo-----B-------f---
m-E--------E---E------------------------------------------|-------------------------------E---------------|-----------------------------E--------------------------------------------------------------X---
XXXXXXXXXXXXXXXXXXXXXXXXXXXXXXXXXXXXXXXXXXXXXXXXXXXXXXXXXXXXXXXXXXXXXXXXXXXXXXXXXXXXXXXXXXXXXXXXXXXXXXXXXXXXXXXXXXXXXXXXXXXXXXXXXXXXXXXXXXXXXXXXXXXXXXXXXXXXXXXXXXXXXXXXXXXXXXXXXXXXXXXXXXXXXXXXXXXXXXXXXXX
