-----------------------------------------------------------------------------------------------------------------------------------------------------------------------------------------------------------
-----------------------------------------------------------------------------------------------------------------------------------------------------------------------------------------------------------
-----------------------------------------------------------------------------------------------------------------------------------------------------------------------------------------------------------
-----------------------------------------------------------------------------------------------------------------------------------------------------------------------------------------------------------
-----------------------------------------------------------------------------------------------------------------------------------------------------------------------------------------------------------
----------------------------------------------------------------------------------------o------------------------------------------------------------------------------------------------------------------
-----------------------------------------------------------------------------------------------------------------------------------------------------------------------------------------------------------
------------------------------------------------------------------------------------XXXXXXX------------------------------------------------------------------------------------------------------------v---
------------------------------------------------------------------------------------------------------------------XXXXXX-------------------------------------------------------------------------------f---
-------------------------------------------------------------------------------------------------------------------------------------------------------------------------------------------------------f---
-------------------------------------------------------------------------------------------------------------------------------------------------------------------------------------------------------f---
---------------------------XXXXX----------------XXXXXXXX------------BBBBBB------XXXXXXX----T-------------------XXXXXXXX------------------T-------o-XXXXXXX---XXXXXXX-----------------------------------f---
-------------------------------------------------------------------------------------------|---------------------------------------------|-------------------------------------------------------------f---
-------------------------------------------------------------------------------------------|---------------------------------------------|-------------------------------------------------------------f---
m---------------E--------------------------------------------------E-----------------------|---------------------------------------------|------------------------------------------E---E--E-----o-----X---
XXXXXXXXXXXXXXXXXXXXXXXXXXXXXXXXXXXXXXXXXXXXXXXXXXXXXXXXXXXXXXXXXXXXXXXXXXXXXXXXXXXXXXXXXXXXXXXXXXXXXXXXXXXXXXXXXXXXXXXXXXXXXXXXXXXXXXXXXXXXXXXXXXXXXXXXXXXXXXXXXXXXXXXXXXXXXXXXXXXXXXXXXXXXXXXXXXXXXXXXXXX
