---B---------------?--o--BXB-----|-T-----T-------B--------------XX-T-------?-E--XXBM------M------X-----ooX------TE-------------E------E-T----X--B----MM?X----T-----T----M----B?----------XE---B--M-?----
-------------o--------To--M---M---?--XX--X--?----E-TB--E---o|o-o---X---B-B-B-----------?-?-------B---------E-------B--o?--------|?------X---------T-o------------XE-----------?---o?---EM-E----EB-------
-----------T------E-BT-B-------?-B----T----E---X--BEE---||-o--?--E-------E---E--BB----Eo-E-----o-E---?-T-------|E-----|E---B--?--E-?-oM-----|-E--X-B--X------?--|-X------oB---E-E-B-B?------------B-----
-Mo------------|-------?-----T------------o-----B---Bo-----------o--E-M------B----?--T|-M------o?o--|X-----------M-?--o------o-B---o---------------------oT---------X---------------X-T--M----M--X--?---
-X---o--?--o|-M-----M------------MT?-----M---?-------To|?--?--||------|----------------------T---------X------||?X--------M---------X-----E-----|-----------X-BTM-?-----X-M-|---------X-------X------T--
----E-|T----M--T----M-X|-------------B-?--M?--------------?---------T-----E--o----?--o------E--X---T--EM-------TT-?-X?|--------------o---------|--B?-EB------------MXM-------?-oM--------------------BT-
--------?---X------X-B--T-M----?--M-----B-EM-----|----oMo------E-X-X--X---BXM-------X------?-?-o-------------|--M-----o---?---o---X-----M--E-T---TX-------E--T----T--XT-oX-------?--o---------------E---
-----EE---T----------|-o-----E-M--MXX------?T---To--X---?------o---|-------B------T---M--X--------------------Mo--------??---EB---M-T-------E-------------||E------M--X-X---B-----|--B-M--|E--T-|MB----v
-M-M----||-o-?X-oE--E-T------?-----EE----------XE---T-|--------M---------E------?----T---------E------------B---------MMM----E----?M---E--|---------B--T---X--M-------------X--B--|--B-------------MoM-f
------XT-|----?-----EE---B--E------oE-----?B-X-------X-----------o-----M-B-----?--------BM------B--------X-?-?-----|---?-MT----B---------?---------o-X-o----M----E--T--X--?--|----------------?--------f
-----T-----X--?-|-X-?M-X------------E---B--------E--|---?--|--E--------?-----B-----------X---X---T-o-?-|----------T--?--------------------M----------|X-----T-|-|X----X---X-X----E---B-|---------------f
-E?-B--o---------------XooToM-T------o--oB---||------|--------B----------------|----?-T-XE---|-----------|---|-o----o--M--?-BT-T-|--B---------------X-o|--------XT-----M----X-M-T--|M-----------o--oo--f
-E---MBE-------o--------o--B---o---o---X-------X-----------XE-------X--|o?---M--------M----o|-X--M---BE-E|B|-----X-?--------?E---T--M-?-o|X-B-BX-?---?------B--?-----B----B-------E-M---------------oX-f
-----XX---?---|-Eo-----MBXo------o---?------|----------E-M-----o---X-X--?o------M----?M------B-----o--B---E---E----oX---T---------M--B---?T----------X?--?B---------M---X-------|B--------------T-?o---f
mB--T----T-T-------B--ET---E-?-|------M----B--?-----------|----M|----E---|---E---E--?B----------?-------------------M------X--B|------X-E-------XX--B------|--X---------X||--M-----T-M-----------T-----X
XXXXXXXXXXXXXXXXXXXXXXXXXXXXXXXXXXXXXXXXXXXXXXXXXXXXXXXXXXXXXXXXXXXXXXXXXXXXXXXXXXXXXXXXXXXXXXXXXXXXXXXXXXXXXXXXXXXXXXXXXXXXXXXXXXXXXXXXXXXXXXXXXXXXXXXXXXXXXXXXXXXXXXXXXXXXXXXXXXXXXXXXXXXXXXXXXXXXXXXX
