-----------------------------------------------------------------------------------------------------------------------------------------------------------------------------------------------------------
-----------------------------------------------X-----------------------------------------------------------o------------o-----o-------------------------------------------------------?--------------------
---X---o-----------------------------------------------------------------o---------------B--------------------------------------------------------------?--B------------------------------------o----------
---------------------------------------------------------------------------X--------------------------------------------------------------X-----X------------------------------------o--o-o----------------
----------------------------X------------------------------X-----------------B------------------------------o-------------------------------------------X--------------------------------------------------
--------------------------------------B-------------------------------X------------B-----?-----o---------------B----o---------------------------?---------o-------------------X------------------X---------
------B------------X---B----------------------------------------------------------o?-----------------------------------------------------------------------o------o-----------o-----X----------------------
-----------------------------------------------------o--------X--------------------------------------------------------------o-------------------------------------------------------------------------v---
-----------X---------X--------------------------------------------------------?-????-------X-X---XXX------XXXX--------------X------------------------------XXXXXXX----------------?--------------------f---
----------------------X-------?????-------?------------------oo-------------o-----------------o--------------------------------------------------XXXX--------------------------------------------------f---
-------------------------X--------------------------------------------o-----------------------BBX--BBB-B---------o------------------------------o------------------------------------------------------f---
-------------------------------------------X----------------------------------o-------o-------XXXXXXX-----------XXXXXXXXX--------o----XXXXXXXX-------------XXXX------------B-----------------o---------f---
------------------------------------------------T-----o---o---------------X------------------------o-------------------oo--------------------------------------------------o--o-------o-------B--------f---
----------------------o--------o----------------|----o--------------------------------------------------?----------------------X---o-------------------------------------------------------------------f---
m-----------------------------------------------|--------------------------------------------------------E---------------------------E---E--------E---------------------------------E------------------X---
XXXXXXXXXXXXXXXXXXXXXXXXXXXXXXXXXXXXXXXXXXXXXXXXXXXXXXXXXXXXXXXXXXXXXXXXXXXXXXXXXXXXXXXXXXXXXXXXXXXXXXXXXXXXXXXXXXXXXXXXXXXXXXXXXXXXXXXXXXXXXXXXXXXXXXXXXXXXXXXXXXXXXXXXXXXXXXXXXXXXXXXXXXXXXXXXXXXXXXXXXXX
