-----------------------------------------------------------------------------------------------------------------------------------------------------------------------------------------------------------
--------------o------------------------------o----o--------------------------------------------------------------------X----------------X------------------------------------------------------------------
----------o------------------------------------------------------------------------------o---o---------------------------------------------------------------------------------------B---------------------
--o-------------------------o--------------------------------------------------------------o----X----------------------------------------------------------------------------------------------------------
----------------B------------------------------------------------------------------------------------------------------------------------------------------------------------------------------------------
-------------------------o------B------------------------------------------------------------X-----X-----------------------o--------o--------------------------?-------------------------------------------
---------------o------------X------------------------------------------------------------------------------------------------------------------------------------------------------------------------------
------------------------------------------------------------------------------------------------------------------------------------------------------------------------------------o------------------v---
-----------------------------------------------o------BBBBB------------XXXXX-XX-------oo-------------------------------XXXXXXXX---------X-----------------X-------X-------?----------------------------f---
--------------------------------Bo------------------o------o---------------------???----?------------------------------------------------------------------------XXX-----------------o-----------------f---
-------------------o---------------------XXXXXX--------------o----------------------XXXXXXX-----------XXXX?------------------------------T--------------X----------------------------------------o-----f---
--------------------------------------XXXXXX--------------------XXX--------------XXXX----------------X---------------------------------T-|-------------------------------------------------------------f---
--o----------------o----------------------------------------------oXXXX--XXXXXX--------------------------------------------------------|-|-------------X-----------------------------------------------f---
--o------X-----------------------------------------------------------------------------------------------------------------------------|-|-------------o-----------XXXXXX-----------o------------------f---
m------------------------------------E------------------------------------------------------------------------E--------o----E----------|-|---------------------------------E---------------------------X---
XXXXXXXXXXXXXXXXXXXXXXXXXXXXXXXXXXXXXXXXXXXXXXXXXXXXXXXXXXXXXXXXXXXXXXXXXXXXXXXXXXXXXXXXXXXXXXXXXXXXXXXXXXXXXXXXXXXXXXXXXXXXXXXXXXXXXXXXXXXXXXXXXXXXXXXXXXXXXXXXXXXXXXXXXXXXXXXXXXXXXXXXXXXXXXXXXXXXXXXXXXX
