-----------------------------------------------------------------------------------------------------------------------------------------------------------------------------------------------------------
---------------------------------------------------------------------------------------------------------------------------------o---o---------------------------------------------------------------------
-------------------------?-------------------------------------o-----------------------------------------------------------------------------o------------o------o-------------------o---------------------
---------X----------------------------------------------------o----o-------o--------------------------o----------------------X--------o-B---------------------?-----------------o----o---------------------
-----------------------------------------------------------------------X---------------------X--------------X-X--------------------------------------------------------------------------------------------
--------------------X-------?-------------------------------------------X----------X----?---------------------------X?XXX-----o----------------------------------------------------o-------o----------o----
--------X--o---------------------------------------------o-----X-------o-----------------------------------------------------------------------X---B-----------o--------------X----------------------------
----------o--X--o-----------------------------------------BXBBBBBB----?-----------------------------------XXXX----XXXXXX----------------------o-------XXXX--------------X---------?---------------o----v---
-------------------------------------------------------------------------o--------------------------------------------------------------------------------o------------------------------------------X-f---
---------?---------------------------------------------------------------------------X-B--------------------------------------X---------------------------------------------X--------------------------f---
------------------?---o--------X--X---o------------------------------------------------------------------------------------------------------o---------XX-----o------o---------------------------------f---
-----------------XX-X----------------o--XXXX-------------XBXXXXX?---------------T-----XXX------X-XXXX--XX-X-------XXBXXXXXXXXXX-------------o-----T---X---------BXXXXXXX-------------------B-----------f---
--o-----------------------------------------------------------------T-----------|-----------------------------------------------------------------|--------------o-------------------------------------f---
-----X--------X-----------------------------------------------------|-----------|-----------------------------------------------------------------|----------------------------------------------------f---
m----------------------E--------------------------------------------|-----------|------------E----------------------------------------------------|----------------------------------------------------X---
XXXXXXXXXXXXXXXXXXXXXXXXXXXXXXXXXXXXXXXXXXXXXXXXXXXXXXXXXXXXXXXXXXXXXXXXXXXXXXXXXXXXXXXXXXXXXXXXXXXXXXXXXXXXXXXXXXXXXXXXXXXXXXXXXXXXXXXXXXXXXXXXXXXXXXXXXXXXXXXXXXXXXXXXXXXXXXXXXXXXXXXXXXXXXXXXXXXXXXXXXXX
