-----------------------------------------------------------------------------------------------------------------------------------------------------------------------------------------------------------
-------------------------------------o---------------------------------------------------------------------------------------------------------------------o---------------------o-------------------------
-----------------------------------------------------------------------------------------------------------------------------------------------------------------------------------------------------------
-----------------o------------------------------------------------------------------------------------------------------------------------------------------------------------o----------------------------
----------X------------------------------------------------------------------------------------------------------------------------------------------------------------------------------------------------
--o------------------?----------o-----------------------------------------o-----------------------------------------------------B--------o-----------------------------------------------------------------
---------------oo----------------------B------------------?------------------o-------------------------------------------------------o-----------------------------X-------X-------------------------------
-----------o---------------------------------------?------------------------------------------------------------------------?--------------------------------------------------------------------------v---
----------------------------XXXXXX---------------------------XXX----XXXXXXXX--XXXXXXXX-------------XXX?XXXX----------T------------------XXXXXX----o----------------------------------------------------f---
-------------------------------------------------------------------------------------------------------------------XX|X-----------------------?--------------------------------------------------------f---
-----------------------------------XXXXXX----------------------------------------------o-----------------------------|-X?XX---BBBBBBXX-------------------T-------o-------------------------------------f---
---------------------------o------------o---XXXX-----------------------o---------------------------------------------|--------------------------------XXX|X----------XX--------------------------------f---
--X--------o--------------o---------T---------------------o--------T----------------------------o------X---o-----o-XX|XXX--------------------------------|-----------XX--------------------------------f---
------------------------------------|------------------------------|-------------------------------------------------|-----------------------------------|-----------XX--------------------------------f---
m------E-----------------------E----|------------------------------|-------------------------------------------------|E-------------------------E---o----|--------E---------------------------E----E---X---
XXXXXXXXXXXXXXXXXXXXXXXXXXXXXXXXXXXXXXXXXXXXXXXXXXXXXXXXXXXXXXXXXXXXXXXXXXXXXXXXXXXXXXXXXXXXXXXXXXXXXXXXXXXXXXXXXXXXXXXXXXXXXXXXXXXXXXXXXXXXXXXXXXXXXXXXXXXXXXXXXXXXXXXXXXXXXXXXXXXXXXXXXXXXXXXXXXXXXXXXXXX
