-----------------------------------------------------------------------------------------------------------------------------------------------------------------------------------------------------------
----------X------------------------------------------------------------------------------------o-----------------------------------------------------------------------------------------------------------
----------X-----------------------------------------------X---------------------o-------------------------------------------------------------------------------------------?----o-------------------------
-----------------------------------------------------------------------------------------------------------------------?--------o---------------------o----------------------------------------------------
----------------------------------------X--------------------------------------B----------o-----------------------B--------------------------X-------------------------------------Xo----------------------
---------------------------------------------------------------------------X-----------------------------------BBBB--?-------------------------------------------------------------------------------------
-----o---o----------------?---------------------------------------------------------------------------o--------------------------------------------------BBBB-----------------X----------------------------
----------------o---------------X????--------------------BXBBBBBB---------------------------------------------------------------BBBBBB--------------------o----------------------o---------------------v---
-------------------------------o-o-----T------------------------------------BBB--------o--------------------X--XBB?-----T-----------------------BBB------BB--------------------------------------------f---
-------------------------------o-------|-------------------BBBBBB------------------------------------------BBB----------|--------------------------------------------BXXB------------------------------f---
-----------------------------o---------|--------------------------------------------------------------------------------|------------------------------------------------------------------------------f---
-------------------------------BBBBBB-B|BBBBBB--BBBBBBBBBBBBBBBB-------XXXXB---------BBB--------BBB------???????---BBBBB|BB-BBBBB?B---BBB----BBBTBXXXXX---------BBB?BBB--------------------------------f---
-----------------------------------o---|--------------------------------------------------------------------------------|----o------------------|-------------------------------------------------B----f---
---------------------------------------|-------------------------------------------------------------o------------------|-----------------------|----------------------------------o------------X------f---
m-E------------------------------------|------------------------------------------------E-------------------------------|--------------E--------|--------------E---E-------------------------------E--EX---
XXXXXXXXXXXXXXXXXXXXXXXXXXXXXXXXXXXXXXXXXXXXXXXXXXXXXXXXXXXXXXXXXXXXXXXXXXXXXXXXXXXXXXXXXXXXXXXXXXXXXXXXXXXXXXXXXXXXXXXXXXXXXXXXXXXXXXXXXXXXXXXXXXXXXXXXXXXXXXXXXXXXXXXXXXXXXXXXXXXXXXXXXXXXXXXXXXXXXXXXXXX
