-----------------------------------------------------------------------------------------------------------------------------------------------------------------------------------------------------------
---------------------o-----------------------o------------------X--------------o---------o----------------------------------------------------------------------B-------------o----------------------------
------------------------------------------------------------------------------------------------------------------BBBBBBXB---------------o-----------------------------------------------------------------
------------------------------------------------------------------------------------------------------------------------------------------------B----------o-----------------------------------------------
-------------?---o----------------------------o--------------------------------E-----------------------------B-BBBB--------------------------------------------------------------------------o-------------
---------?--o----------------------------------------------BBB----------XB--B-BB-------o------------------------------------X----------------------------------------B---------X---o-----------------------
-----------------------------o------------------------?------------o-o-----------o--o----------------------BBBX?BXB----------------------------------------------------------------------------------------
----------------------o------------------------------BBX-B-BB-----------o---------?-------o-------------------------------------------------oBXB---------------BBBBX?B-B-------------------------------v---
----------------------------------------------------T-------------------------------------BBXBBX--------??X??--------------o-------T-------------------o-----------------------------------------------f---
-----X----------------------------------------------|--------------T-----BBBBBB---------------------------------------------o------|---------------------------------o---------------------------------f---
-----------------------------o--------------X-------|--------------|-------------------T--------------------T----------------------|------------------------------------------------------o------------f---
-----------------------------------T---------B-BBB-B|B-B-------TT??|?---X-XX-----------|B-BBBT-BB-X????-???-|--o---------------BBBB|BBB------BBB----------BBBBBBB---------------------------------?----f---
---------?-----------T-------------|----------------|-----o----||--|-------------------|-----|--------------|---T-To----------T----|--------------------------------------?-o-------------o---------o--f---
---------------------|-------------|--o-------------|----------||--|-------------------|-----|--------------|---|-|-----------|----|B---o--------------------------------------------------------------f---
m--------------------|-------------|----------------|----------||--|----------------E--|-----|E-------------|---|-|---E-------|----|--------E-------------------------E-----------------------E--------X---
XXXXXXXXXXXXXXXXXXXXXXXXXXXXXXXXXXXXXXXXXXXXXXXXXXXXXXXXXXXXXXXXXXXXXXXXXXXXXXXXXXXXXXXXXXXXXXXXXXXXXXXXXXXXXXXXXXXXXXXXXXXXXXXXXXXXXXXXXXXXXXXXXXXXXXXXXXXXXXXXXXXXXXXXXXXXXXXXXXXXXXXXXXXXXXXXXXXXXXXXXXX
