-----------------------------------------------------------------------------------------------------------------------------------------------------------------------------------------------------------
------o---------o-----------------------------------------------------------------------------------------------------------------------X------------------------------------------------------------------
---------X-----------------------------------------------o-----------------X-------------o---o-----------------------------------------------------------------------------------------o-------------------
-------------------------------------------------------------------------------------------o----X----------------------------------------------------------------------------------------------------------
-----------------------------------------------------------------------------------------------------------------------------------------------------------------------------------------------------------
---------------------------------------------------------------------------------------------X-----X-----------------------o--------o--------------------------?-------------------------------------------
--------------------X--------------------------------------------------------------------------------------------------------------------------------------------------------------------------------------
------------------------------------o------------------------------------------------------------------------------------------------------------------------------------------------------------------v---
--------------------------------o------------XXXXTXX------------XXXXX--XXXXX-XX--------o-------------------------------XXXXXXXX---------X-----------------X-------X-------?----------------------------f---
-------------B-----------------------------------|------------o------------------???----?------------------------------------------------------------------------XXX-----------------o-----------------f---
-------------------------------------------------|----------------------------------XXXXXXX-----------XXXXX------------------------------T--------------X----------------------------------------o-----f---
---------------------------------------T---------|--------------XXX-------X------XXXX----------------X---------------------------------T-|-------------------------------------------------------------f---
---------------------------------T-----|---------|---------XX-o----------?XXXXX--------------------------------------------------------|-|-------------X-----------------------------------------------f---
--------X------------------------|-----|---------|-------------------------------------------------------------------------------------|-|-------------o---o-------XXXXXX-----------o------------------f---
m---E----------------------------|-----|---------|----E-------------------------------------------------------E--------o----E----------|-|---------------------------------E---------------------------X---
XXXXXXXXXXXXXXXXXXXXXXXXXXXXXXXXXXXXXXXXXXXXXXXXXXXXXXXXXXXXXXXXXXXXXXXXXXXXXXXXXXXXXXXXXXXXXXXXXXXXXXXXXXXXXXXXXXXXXXXXXXXXXXXXXXXXXXXXXXXXXXXXXXXXXXXXXXXXXXXXXXXXXXXXXXXXXXXXXXXXXXXXXXXXXXXXXXXXXXXXXXX
