-----------------------------------------------------------------------------------------------------------------------------------------------------------------------------------------------------------
---o-------------------------------------------------------------------------o--------------------------------------o------------------------------------------o-------------------------------------------
----------------------------------------------------------------------------------------------------------------------------------X-----------------------------------o------------------------------------
--o--------------o-------------o------------------------------o---------------------X------------------------------------------------------------------------------X-------------?----------X--------------
----------------------------------------------o-----------------------------o-----X----------------------------------------------------------------------------------------------X-------------------------
------------B----------------------------------X-----------------B---------------------------B-X--------X??------------------X------------------------X----X---?-----X-------------------------------------
--------X----------------------o--------------------------X---------------X--------o--------------o-----------------------------------------------------------------------------------X-------------o------
-B-------B------------------------------------BX--------------------o-----------------o--------------B-----------------BBXB--------X-o------------------------------------------------o----------------v---
--------o----o--------------------------------------------------------BBBBBBBB--o-------------------????????----o-------------------------------------T------------------------------------------------f---
-----o---------------------------------------------------------o--------o------------------------------------?------------------------------------o---|------X---------------------X-------------------f---
----------------------------------------------o----------------------------------------T-----------------------------------------------o--------------|------------------------------------------------f---
-----------------------X----BBB-BBX---------BBBB---------X-BBB-B-----BB--?-------------|--BX----BBBBBBBB--BBB--BBBBB?---------------BBBo----------?B??|??---X-------------------------o----------------f---
-----------------------------------------T---------------------------------------------|---------------------------X---------------o------------------|-----------------------------B------------------f---
---------------------B----------------o--|----------------o----------------------------|------o------------------------------------------o-----o------|------------------------------------------------f---
m-E--------------------------------------|------------------------------E--------------|--------------------------------------------------------------|-----------------E------------------------------X---
XXXXXXXXXXXXXXXXXXXXXXXXXXXXXXXXXXXXXXXXXXXXXXXXXXXXXXXXXXXXXXXXXXXXXXXXXXXXXXXXXXXXXXXXXXXXXXXXXXXXXXXXXXXXXXXXXXXXXXXXXXXXXXXXXXXXXXXXXXXXXXXXXXXXXXXXXXXXXXXXXXXXXXXXXXXXXXXXXXXXXXXXXXXXXXXXXXXXXXXXXXX
