-----------------------------------------------------------------------------------------------------------------------------------------------------------------------------------------------------------
------------------------------------------------------------------o---------------------------------------------------------------o-----------------------o-----------------------o------------------------
---o-----------------------o--o--------o----------------------------------o----------------------------------------------------------------------------------------------------------------o---------B-----
----------------------------------------------------------------------------------------------------------?------------------------------------------------------------------------------------------------
-------------------------------------------o--------------------------------------------------------------------------------------------------------------------------------------------------------o------
---------------------------------------------------------------------------X--------------------------------o----------------o--o--------------------------------------------------------------------------
---------------------------o-------------------------X-----------o-----------------------------------------------XXXXXX-----------------------------------------o-------o-------------X-------o------------
--------?----------------------------------------------o------X--------X-------o------------------oX---------------------------------------------o----------------------o------------------------------v---
----------------------B---------------------------XXXX---To------------------------------------------------------XXXX--------------------------------------B------------X------------------------------f---
-------------------------------------------X-------------|o------------------XXXXBX-------------------------------------------------------X--------------------------------------?---------------------f---
---------------------------------------------------------|-----------------------------------------------X---------------------------------------------------------------------------------------------f---
----------------------o-----XXXXXXXB--?B???o-----XXXX-X-X|XXXX---------X-----BBBBB--XXX----X?XX---oo----BBBBBBB-------XXXXXXX-------o?XXXX-----XXX-B--------------------B------------------?-----------f---
-----------------o---------------------------------------|-------o-------------------------------------T---------X------------o--------------------------------T---------o----o------------------------f---
------------------o--------------------------------------|----------------X---o------------------------|-------------------------------------------------------|---------------------------------------f---
m-E------------------------------------------------------|------E--------------------------------------|---------E-----------------------------E---------------|-----E---------------------------------X---
XXXXXXXXXXXXXXXXXXXXXXXXXXXXXXXXXXXXXXXXXXXXXXXXXXXXXXXXXXXXXXXXXXXXXXXXXXXXXXXXXXXXXXXXXXXXXXXXXXXXXXXXXXXXXXXXXXXXXXXXXXXXXXXXXXXXXXXXXXXXXXXXXXXXXXXXXXXXXXXXXXXXXXXXXXXXXXXXXXXXXXXXXXXXXXXXXXXXXXXXXXX
