-----------------------------------------------------------------------------------------------------------------------------------------------------------------------------------------------------------
-------------------------------------------------------------------------------------------------------------------------------------------------------X-------------------------o-------------------------
---------------------------------------------------------------------------------------------------------------------------------------------------------------------------------------o----------o--------
----------------------------------------------------------------------------o------------------------------------------------------------------------------------------------------------------------------
----------------------------------------------------------------o------------------------------------------------------------------------------------------------------------------------------------------
-----------------------------------------------------------------------------------------------------------------------------------------------------------------------------------------------------------
---------------------------------------------------------------------------------------------------XXXX----------------------------------------------------------------------------------------------------
-----------------------------------------------------------------------------------o--------XXXXXXX-----------------X----------------------------------------------------------------------------------v---
----------------------------------------------------------------------------------o-------?-----------------------------------------------------------------------X------------------------------------f---
------------------------------------------------------------------------------------------------------------------------------------------------XXX-----------------------------------o----------------f---
-------------------------------------------------------------------------------------------------------------------------------------o------------------------------------------------o---------o------f---
-----------------XXXXX---------XXXXXXX---XXXXXo------???XX------XXX---XXXXXX---BBBBBBBB---XXX-o---------------------X------BB-BB-----XXXXXXXXXXX---------XXXXX-T-------------------------X-------------f---
---------------------------------------------------------------------------------T---------------------T--------------------X------X----------------o---?------|---------------------------------------f---
---------------------------------------------------------------------------------|---------------------|-------------------------------------------------------|---------------------------------------f---
m---------------------------E-------E--------------------------------o-----------|-------------------E-|-------------------------------------------------------|----------------o--------------------E-X---
XXXXXXXXXXXXXXXXXXXXXXXXXXXXXXXXXXXXXXXXXXXXXXXXXXXXXXXXXXXXXXXXXXXXXXXXXXXXXXXXXXXXXXXXXXXXXXXXXXXXXXXXXXXXXXXXXXXXXXXXXXXXXXXXXXXXXXXXXXXXXXXXXXXXXXXXXXXXXXXXXXXXXXXXXXXXXXXXXXXXXXXXXXXXXXXXXXXXXXXXXXX
