-----------------------------------------------------------------------------------------------------------------------------------------------------------------------------------------------------------
-----------------------B----------------------------------------------------------------oo------------------------X--------------------------------o---------------------o-----------o---------------------
--------------------------------------o------------------?---X---------------------------------------?---------------------------o------------------------------o------------------------------------------
--------------------------------------------------------------------------------------------------------------------o-----o--------------------------------------------------------------------------------
------------------------------X----------------------------------------------------o-------------------------------------o--------------?------------------------------------------------------------o-----
----------------------------------?-------?-----------------------X-------X----------o------------------------o----X----------------------------------------------------------X---------o------------------
--------o----B-------------------------------------------------------------------------------------------------------------------------------------o-------------------------------?-----------------------
-------------o-----B---------o------------------------------o-------o----------------------------------------?----------------------B------------------------------------------------?------X---o------v---
---------------------------------------------------------o-------------X-------------------------X----------------------------------------B--------------------------------X---------------------------f---
------------------X------------------?----------------------o------X----------------------------------o-----------------X---------------------------------------?--------o--------o--------------------f---
--------------------------------------------o?------o-X---------------------------------o---------------------------------oB--------------------T------------B--------X--------------X----o------------f---
---o-----------------X---------------------T-----------------------------------------------T------X-------------------------------------T----T-o|--------------B--------?----------------B-------------f---
-------------------------------------------|-o---------------------------T-----------------|---T-----------------T----------------------|----|--|--------------To--------------X-----------------------f---
--------o---------------o------------------|-----------------------------|-------------?-o-|---|-----------------|----------------------|-o--|--|--------------|--------------B------------------------f---
m----------------------------------------E-|-----------------------------|---------E-------|---|-----------------|----------------------|----|--|-E-------o----|---------------------------E-----------X---
XXXXXXXXXXXXXXXXXXXXXXXXXXXXXXXXXXXXXXXXXXXXXXXXXXXXXXXXXXXXXXXXXXXXXXXXXXXXXXXXXXXXXXXXXXXXXXXXXXXXXXXXXXXXXXXXXXXXXXXXXXXXXXXXXXXXXXXXXXXXXXXXXXXXXXXXXXXXXXXXXXXXXXXXXXXXXXXXXXXXXXXXXXXXXXXXXXXXXXXXXXX
