-----------------------------------------------------------------------------------------------------------------------------------------------------------------------------------------------------------
-------------o----------------------------------------------------------------X----------------------------------------------------o------------------------------------X-------------------B--------------
-------------------------------o--------------------------------o----------------------o-------------------------o---------------X------------o------------------------------------------------------------
----------------------------o-----------------------------------o----o--------?BBBXBB---------------------------------------------o-----------------------------------------------------------o------------
----------------------------o---------------?-----------------X--o--------------------X--------------------------X------------X----------------------------------------------------------------------------
--------------------------o--------------B------------Xo-X----------------BBBB--BBBBB-X----o--X-----------o---------------------------------B-------B----X???-------------X--------------------------------
--------------o--------X--------------------------o-------------------------------------o------------X-----------------------------------------------------------------X--------------o--oo----------------
-----------------------B--B-B---------------------XBBB?-BX-----------o----oXXXXXXXX--o-X---------------------o-------BXBBBB--------------------------BXBBBBB------------------------------X------------v---
-----------X-----------------------------------------------T-BBB?----------------------------------------------B-o--------?-----------------------------------------X--------------------o-------------f---
--------o---------------------o----------------------------|-o----------BBB------------------------------o---BBB----B?BBB---------------------------------------------------------o---------o----------f---
---------------------------------------------o-------------|---------o-o---------------------o--------------------------------------------------------------------------------------X------------------f---
-----------------o----B--B-BB------X---------???-BB-BBBBB-X|-o---BBX-BBBBBBB-----???????--------BBB-To-----BBB------BBBBB-----T--BBXBB--XXXX---????XX?X---XBBBBB----X----------------------------------f---
--------------------------------------------------------o--|--------T-------------------------------|-------------------------|----------------------------------------------X-------------------------f---
--------------------B--------------------------?-----------|--------|--o---------o------------------|-------------------------|-----------------------o------------------------------------------X-----f---
m----E-----------------------------------------------------|--------|-------------------------------|-------------------------|---E-----E----------------------------------------------------E---------X---
XXXXXXXXXXXXXXXXXXXXXXXXXXXXXXXXXXXXXXXXXXXXXXXXXXXXXXXXXXXXXXXXXXXXXXXXXXXXXXXXXXXXXXXXXXXXXXXXXXXXXXXXXXXXXXXXXXXXXXXXXXXXXXXXXXXXXXXXXXXXXXXXXXXXXXXXXXXXXXXXXXXXXXXXXXXXXXXXXXXXXXXXXXXXXXXXXXXXXXXXXXX
