-----------------------------------------------------------------------------------------------------------------------------------------------------------------------------------------------------------
--------------------------------o-----X---------------------------------------------------------------------------------------o------------------------------------------------o--o------------------------
--------o------------------B-----------o------o---------------------------------------------------------------------------------------------o------------------o-------------------------------------------
----------------------------o---------------------------o-------------------------------------------------------------------X---------------------------o--------------------------------------o-----------
-----------------------------------------------------------------------------------------------X--------------------------------------------------------------------X--------------------------------------
----------------------X--------o---------X------o---------?-X----o---------X---------X-------------------------------------------X---o---------------B-----------------------------------------------------
-----------o----------------------o-----------------X----------o-----------------------------------o-----------------?------------------o---------------------------------?--------------------------------
-------X---------o-------------------------X----B-------o-----------o-------------------------o---o-----------------------o--o------------------------X------------------------------------------------v---
------------------o----------XXX------------------------o----------------------------------X--------------------------------X------------------------------XXXXXXX--o----B-----------------------------f---
----------------X--------------------XXXXBX---------------------XXXX---------------------------------XXXXXX??X???X------------X--------------BBB---BBB----XXXBXBXo--------------------o-?--------------f---
------B----------------o-XXXXXX--------------------o---X---o-------------------------o---------o---------------------------------------------X--------------------------------------B------------------f---
----------------o----o-------------o------------------------------------------o--------------BBBBBBBB--XXXX-------XX?--X---------X----X?XBXX--------------------------X---------------?-------------o--f---
-------------------------------------------------------o------------------X------------------------------------------o-------o-----o-------------------------------------------------------------?-----f---
-----X-o--------------------------------------X-----------------------------------------------------X------o-----------------------o--?-----------------------------------------------------?----------f---
m---------------------------------E------------------E-------E--------------------E--------------------------------------------------E---E-------------------------------------------------------------X---
XXXXXXXXXXXXXXXXXXXXXXXXXXXXXXXXXXXXXXXXXXXXXXXXXXXXXXXXXXXXXXXXXXXXXXXXXXXXXXXXXXXXXXXXXXXXXXXXXXXXXXXXXXXXXXXXXXXXXXXXXXXXXXXXXXXXXXXXXXXXXXXXXXXXXXXXXXXXXXXXXXXXXXXXXXXXXXXXXXXXXXXXXXXXXXXXXXXXXXXXXXX
