-----------------------------------------------------------------------------------------------------------------------------------------------------------------------------------------------------------
-----------------------------------------------------------------------------------------------------------------------------------------------------------------------------------------------------------
----------------------------------------------------------------------------------o------------------------------------------------------------------------------------------------------------------------
-------------o-----------------------------------------------o---------------------------------------------------------------------------o----------------------------o------------------------------------
-------------------------------------------------------------------------B-------------------------------------------------------------------XB------------------------------o------X----------------------
---------------------------------o-------------------------------------------------------------------------------------------------------------------------------------------------------------------------
----------------------------------------------------------------------------------------------------------------------------------------X------------------------------------------------------------------
-----------------------------X---------X------X-----------------------o-----------------------------------------------------------------------------------------------------------------------?--------v---
--o-------o-------------X-------------------------------------XXXXXXX--------------------------------XXXXXX-----------------o---------------------X???--T-------------------o--------------------------f---
----------------------------------------------------XX-------XXXXX-????????---o----------------XXXXX---------------o--XXX------------------------------?|----------------------------o-----------------f---
-----------------------------------X----------------------------------??????----------------------------------------------------------------------------|----------------------------------------?-----f---
----------------------XXXX-----------------T-------o--------------XXXXXXX-----------------------XXXXXXXX------------------------------------------------|----------------------------------------------f---
------------------------????????--------XXX|-------------------------?-------------------------------------T---------------T------------------------XXXX|X---------------------------------------------f---
--------------------------BBBBBB----------o|------------------------o?????-----oXXXXXXXX-------------------|---------------|----------------------------|----------------------------------------------f---
m------------------------------------------|--------------------------------------------------E------------|------------E--|----------------------------|----------------------------------------------X---
XXXXXXXXXXXXXXXXXXXXXXXXXXXXXXXXXXXXXXXXXXXXXXXXXXXXXXXXXXXXXXXXXXXXXXXXXXXXXXXXXXXXXXXXXXXXXXXXXXXXXXXXXXXXXXXXXXXXXXXXXXXXXXXXXXXXXXXXXXXXXXXXXXXXXXXXXXXXXXXXXXXXXXXXXXXXXXXXXXXXXXXXXXXXXXXXXXXXXXXXXXX
