-----------------------------------------------------------------------------------------------------------------------------------------------------------------------------------------------------------
------------------------------?------o---------------------------------------------------------------------------------------------o----------------------------o------o--o-----------?--------------------
----------------------------------------------------------------------------------------------------------o------?-----o-----------------------------------------------------------------------------------
----------------------------------------------------------------------------------------------------o----------------------------------------------------B---------------------------o---------------------
-----------------------------------------------------------------o-------------------X----------------------o----------------------------------------------------------------------------------------------
------?-------X----------------X--------------o-----------?----------------B------o-----------------X------------------------------?------o-----------------------------------X----------------------------
---------?--------------o----------?------o--o------------------------------X-------------------------------------------------------------------------------------------------o----------------------------
-----------------o------------------------------?------------------------------------------------------------------------------------------------------------------------------------------------------v---
---------o-------------oo----XXBXXX-------T--o----------o----------?-------------XX-------------o----XX?XX----------------------?-B-BBBBB---------BXXBB------------o--------------?o-------------------f---
----------------X-------------------------|----------------X----XXXX--------------------------------------------XXXXXXXX----------??X-----------X-----------------???????B---------------------B-------f---
-------------------------XXXXXX-----------|--------------------------------X?XXXX-------------------------------o----------o-------------------------------???----o-------X----------------------------f---
-------------------ooo---------X--o-------|-----o----------------------------XX?X-----o--o-----------o---------------BXXX----------------T-------------------------------------------------------------f---
-------------------------------X---------X|XXX---------------------------oXXXX-------------------BBXBB-----------------------------------|-----------T---T---------X--------------------------B--------f---
------------------------------------------|----------------------------------X---XX------------o-------------o--------------X-----------o|------XXXXX|X--|---------------------------------------------f---
m-----------------------------------------|----------E-------E-----------------------------------------E---------------------------------|-----------|---|-E------------------------E------------------X---
XXXXXXXXXXXXXXXXXXXXXXXXXXXXXXXXXXXXXXXXXXXXXXXXXXXXXXXXXXXXXXXXXXXXXXXXXXXXXXXXXXXXXXXXXXXXXXXXXXXXXXXXXXXXXXXXXXXXXXXXXXXXXXXXXXXXXXXXXXXXXXXXXXXXXXXXXXXXXXXXXXXXXXXXXXXXXXXXXXXXXXXXXXXXXXXXXXXXXXXXXXX
