-----------------------------------------------------------------------------------------------------------------------------------------------------------------------------------------------------------
-------------------------------------o-----------------------------o------------------------------X-------------------------o-------------X----------------------------------------------------------------
----------------------B-------o-----------------------------------------------o--------o--------------X--?-------------o-------------------------------------------o---------------------------------------
-------------------------------------------------------------------------------------------------------------------------------o---------------------------------------------------------------------------
------------X-----------------------oX--------------------------------------B--------------o-------o--------o-----B------------X------------------------Xo-----------------------o-----------?-----?-------
-o--------------------------------o-X--------?o-o--------------o---------o---------------X--------X-------------------X----------o----o--X---o---?---------------B---o-----o-------------------------------
---------------X-----------------------------------------------X---------------o------------------------------------o--X-----------------o----------------------------------?-----------X-o----------------
------------------------X-----------------------------------BBBB-BBB---------o------------X-----------------------------------------------------------X---o?------------------------o------------------v---
---B-----------o-?--------X--------X-------------X--o--------------------------------------------------------------------------------------------------------T----------o-----------o----o-------------f---
--------------------o----o----------T---------X------------T--o------------------o-----T-------o----------------------BBBBBB---------------------------------|------o--------X---?------------o--------f---
-----------------------o------------|----T----------------X|------------------------o--|---------T------------------------------------------------------o--o-|-X--------------------------B------------f---
----X------------------------------B|B-BX|-------------o-TBTBX---BBXBBBB-------------BB|BBB------|------------BBBXX-BBBBBB---o-----------------T--------o---B|B-----o----------------------------------f---
------------------------------------|----|-T-X----X------|-|------oX-------------------|---------|-----------------------------------X-o-------|---o---------|-----------------------------------------f---
----o-----------------------------o-|----|-|-------------|-|-------B-------------------|---------|--------o------------------------------------|-------------|------------------------X----------------f---
m-----------------------------------|----|-|------E------|-|---------------------------|---E-----|---------------------E-----------------------|-------------|--E--------------------------------------X---
XXXXXXXXXXXXXXXXXXXXXXXXXXXXXXXXXXXXXXXXXXXXXXXXXXXXXXXXXXXXXXXXXXXXXXXXXXXXXXXXXXXXXXXXXXXXXXXXXXXXXXXXXXXXXXXXXXXXXXXXXXXXXXXXXXXXXXXXXXXXXXXXXXXXXXXXXXXXXXXXXXXXXXXXXXXXXXXXXXXXXXXXXXXXXXXXXXXXXXXXXXX
