-----------------------------------------------------------------------------------------------------------------------------------------------------------------------------------------------------------
----------------------------------o---------------------------------------------------------o--------------------------------------------------------------------------------------------------------------
---------------------X------------------------o-----------------------------------------------------------------------------------------------------------o------------------------------------------------
-------------------o-------------------------------------------------o-------------------------------------------------------XXXXXX--X---------------------------------------------X-----------------------
------------------------o---------X------------------------------------?--------------------------------X--------------------------------------------------------------------------------------------------
---------X----------------------------------------------------------------------X--X-----------------------------------------------------------------------------------------------?-----------------------
-----------------------------------X-------?--B----------------B--------------------------o---------------------------------------------------X-------------------------------X----------------------------
----------------X----------------------------------------o---------------------------------------XXX-------------------XX--XXX---------------------------X--------------X-------------------B----------v---
----------------o-------------X------------------------------------?X???B-----------------B----------------X-X-----X-o-------------------------o-o---------------------------------------------------X-f---
---X----------o----------------------------X-----------------------------------------XX----------------?---------------------X----------------------------------------------X--------------------------f---
---------------------------------B--------------------------------o------------------------------------------------------o---B------------X----o---------------------o---------------------------------f---
---------------XXXX-XB---o------------------------o--XXXXXB--XXXXXXXX------------oo---XXX-XXX--XX----------?-??----XXXX---------------------------T-----B-------XXXXXXXX-------------------B-----------f---
------------------------------T------------------------------------B-------------oT-------------------------------------o-----------------o-------|-----o---------o------------------------------------f---
---------o--o-----------------|---------------------------------------------o-----|---------o-------------------o---------------------X-----------|----------------------------------------------------f---
m----------------E--o---------|-------E-----E-------------------------------------|----------E----------------------E-E---------------------------|----------------------------------------------------X---
XXXXXXXXXXXXXXXXXXXXXXXXXXXXXXXXXXXXXXXXXXXXXXXXXXXXXXXXXXXXXXXXXXXXXXXXXXXXXXXXXXXXXXXXXXXXXXXXXXXXXXXXXXXXXXXXXXXXXXXXXXXXXXXXXXXXXXXXXXXXXXXXXXXXXXXXXXXXXXXXXXXXXXXXXXXXXXXXXXXXXXXXXXXXXXXXXXXXXXXXXXX
