--------------------------------------------------------------------------------------------------------------------------------------------------------------------------------------------------------
--------------------------------------------------------------------------------------------------------------------------------------------------------------------------------------------------------
-----o---------------------------------------------o-------o---------------------------------------------------------------------------------X----------------------------------------------------------
------------------------------------------------------------------------------------------------------------------------------------------------------------o-------------------------------------------
--------------------------------------------------------------------------------------------------------------------------------------------------------------------------------------------------------
--------------------------------------------------?----------------B--------------o---------------------------------------------------------------------------------------------------------------------
----------------------------o------------------------------------oo-------------------------------------------------------------------------------------------------------------------------------------
---------------------------------------------------------------------------------X---------------------------------------------------------------------------------------------------------------------v
------------------------------------------------------------------------------o-------------------------------------XXXXX---XXXXXXX--------------------------------------------------------------------f
-----------------------------------B-----------------------BB?BBB------------------------------------------------------------------------------XXX-----------o-----------------------------------------f
-----------------------------XXXXXX---------------------------------------------------------BXXXXXXXXX---------------------------------------------------o---------------------------------------------f
--------------------------------------XXXX--------------------------??????------------------------------------XXXXXXXXXXXX--------------------------------X--------------------------------------------f
----------------------------------------o-o-----XXXX-----------------------------------------------------------------------------------------------E------o--------------------------B-----------------f
----------------------------------------------------------------------------------------------------------------------------------------------XXXXXXX--------------------------------------------------f
m---------------------------------------------------------------------------------------------------------------E-----------------------------------------E-----------------E--------------------------X
XXXXXXXXXXXXXXXXXXXXXXXXXXXXXXXXXXXXXXXXXXXXXXXXXXXXXXXXXXXXXXXXXXXXXXXXXXXXXXXXXXXXXXXXXXXXXXXXXXXXXXXXXXXXXXXXXXXXXXXXXXXXXXXXXXXXXXXXXXXXXXXXXXXXXXXXXXXXXXXXXXXXXXXXXXXXXXXXXXXXXXXXXXXXXXXXXXXXXXXX
