--------M--oo--------B----o-----E--o-?--E?M---E---|-|------|----------X---X-E------B---o--MX|-------?-E-X-----EX-----------oT----|--B----MB---------o-o-----?-----E---|?-E--X----E----|-X--T-|E-B-|--o--
-----?-----o---T-E-----T---M--?--T------oB------M--------------BoM--B---------E---------M---------------T---------X----|----|---|---------E--o--o-MEX-------EB-M--BM----|--------o------E-----------MB--
-E----M--E---M-------o-oo------o-XT----Xo?T-ME--o--?---XX-X-E--------B-X---------?--oX--?-X---T--X---?E|-------B-|------B----o--M-o-?--M-M------X------M-X------T--------------BM---------------M----T--
--------XXB-----B------o----E-B-X-?------o--oX-------------MB---B---BX-----------TX-o---?X--M-B??----|----Bo---B--E--T-B-Bo?o-------o-----E----o---|--M---EE------------X--X|----?-------To-----X---M-?-
---?ET-E---------X---------------B--E-----E------B----------------?--||-?-B---o-?--E--------X--E----------T--|---TB---?---E-X------T-------------o------B-M----o-------T-------------B--X--------|--?---
-o----T-?--o-E--o-------X-M-o---T?-----------MMM-?------B-------------|----M-----X----------B?E--T---M--?-o---?--------?---X-X-M-----E----E-T----E---M-M-M-------E-T-|--T----X-----?---M------X----|?---
------EMBTX------BT--|--|-------??--E-?--?-o----------------o---M-Eo--E--------o-----o-X?-?M?E--E-X--X--o---|---|---M|-M-------------TTB-----------X|----M-M-----?-----|-E--?--E-----?------------------
--o--BB---|-E---o|?------------?---o-X------------------E-T--B---T----TTX--T---|-B----M--||---------------B----B------------?--|------------B-----E--------|X-|-EE-X--?M---?-----M--T----o-?------X---Ev
---oX--T-To-----B--o-B----------|------B--|--E---T----BEETo-B---B----B|M------M-o--?------T-B----X-------M--M--B--M---T--T-BT--M----X-M---M-X--XTM--X-M---------|-----------?-B------------E-X------TE-f
--M?--?E-E-------B---?--------o--X------BM--X------oX--B-----M---E--|-E---o----X--------??-------X-----------X----M---T---TB--E--------X------E-----To|-------|--M----?----M?--o--?----X-B-|-X--E------f
------?--T----T-B-T-T--?-?--?-X-TT--------?---M--------B----|Bo?---|------T------?------T---B---------------?--M---EM-------o-M-----M--------M----T----o--B-?---T-MX-------------------------T-|-ToT---f
----?--T-oo-|E-|-B-Eo-------B-?----M-T-----E---------X---M--------M-----E----E-----?--B----|--------B----|--E---|B-------M--Mo------|?--B------T----------o-oo?-T-------------E-B-T---------X---X|-E---f
----B---E--X---M-----?----|--oMT---E--------M-X-o--|----?------oX--o----B-----?-B---B-B--B-TEE-------------------B------|?-|------M-------T--T-|----------|--XBM----?-----X-------B-----------E---T----f
------X---TE-B-----|-MT------B---E----?--o----M------------|---?-----T?----o-X------o|X--o-?---T-X-XBM---------B--------o-------|--B--EXoo-|-TX------?--------E-----BE-o------oo?---M---o|-EBE-E---o---f
m---|B-o---E-M-M?|----BE--M-------T-----T--Mo-BBX-|---?---|-------?BT--B----X-o-|-TEX----T-----BE--|-o-B-E------B--------EBo-|---M----MT------B------B---M-----E----X-X?----TE----|-----T-T?-M---------X
XXXXXXXXXXXXXMXXXXXXEXXXXXXXXXXXXXXMXXXXXXXXXXXXXXXXXXXXXXXXXXXXXXXXXXXXXXXXXXXXXXXXEXXXXXXXXXXXXBXXBXXXXXXXXXXXXXXXXXXXXXXXMXXXXXXXXXXXXXXXXXXX|XXXXXXXXXXXXXXXXXXXXXXXXXXXXXXXXXXXXXXXXXXXXXXBXXXXXXXX
