-----------------------------------------------------------------------------------------------------------------------------------------------------------------------------------------------------------
------------X----------------------------------------------------------------------------------------------------------------------------------------------------------------------------------------------
-------------------o----------------------------------o-------------------------------o------------------o----------------o-------------o---------------------o--------------------------------------------
---------------------------------------o-------------------------------------------------------------------------------------------------------------------------------------------------------------------
-------------o-----------------------------?---------------------------------------------------------------------------------------------------------------------------------------------------------------
----------o---------------o------------------------------------o-----------------------o------------------------------------o-------------------------------o--------o-X-----------------------------------
--------------------------------------------------------------------------X-------------------X------------------------------------o----------------------------------?------------------------------------
-------?--------?----------------------------------------------o------------------------------------X-------------------------------------------------------X--------------------o-------------------o-v---
------------------------------?X??------------XXXXXX----------------------------B-----------------?----------------------------------------------o-----------------------------------------------------f---
---------------o-------------------------B----------------XXXXXXX------T----------------XXXXXXXX--------------?-------XXXX----o------------------XXXX--------------------------------------------------f---
-----------------------XXX---------------------------------------------|-------------------------------------------------o------o---XXXXXX-XXX------------------------------------?--------------------f---
------------------oo-XXX---------------------------------X-------------|--------------------------------------------o-----------o------o----------------------------XBXXXX------------------B----------f---
-----------------------------------------------------------------------|----------------------------XXXX------o-----------------------------------------------------------------------------o-X--------f---
---------------------------XXX--XXXXXXX------------X---X-----XBX?------|-----------------------XXXX-----XXXXXXBXXXX?XX--------XXXXXX-------------------------------------------------------------------f---
m----------------------------------------E-----------------------------|------E--E---------------------------------------------------------------------------------------------------E-------------E---X---
XXXXXXXXXXXXXXXXXXXXXXXXXXXXXXXXXXXXXXXXXXXXXXXXXXXXXXXXXXXXXXXXXXXXXXXXXXXXXXXXXXXXXXXXXXXXXXXXXXXXXXXXXXXXXXXXXXXXXXXXXXXXXXXXXXXXXXXXXXXXXXXXXXXXXXXXXXXXXXXXXXXXXXXXXXXXXXXXXXXXXXXXXXXXXXXXXXXXXXXXXXX
