-----M--T--E--X-------oT-------EM---B----------?--|T----ME?-o----E-|X-o--?----o---X---X-o----------?------------o-|---M-?---B---XX-o-o------|-ME-|--?-Mo-|---o?---X-o-----o-X----|-----EEo------E-----?-
----B----------|----?B-----------M-------------T-MEo----------?---X-----X-------------oB-?--|X----M--M-E-M------E-o-o-T---M-?----B-----X-oE----------o------|-?----TX-?-X---o------|--|----XBo--?----?--
-B---|--------------------T-M-------o--o-----E---M----X-BB---E-----B----T------T------o--------o-----X-----------?B----------E--E?E-o---?-?M---?o----------------------T---T|---------TT-----E?-M----|--
-E--------X---T----?--M-----X---------B?X-----?--|----EM?--|--|--|-o--------XM-----X---X-------BMT--o--------------o----EM--M-----T-E-----?--M--------------------X-M------------o--E-?-----------------
-TM|M-------|E----------TB----|M-M-|----------XM--E----E-----TX-X---?----X---?o-M-X-M----T---E-----------T?----|-?T--EEEoT?-------E----------------?---?--X-MX----o-----|---?X----E-E-M---o--o---|?-E---
-------M-------M-E--o----o-|?--------o-------------M|---------M--M?-----------|T-----M----M-TM--X-|-|M---TM------B?-|-|-E---------M-----X-|E-M?-M-|--M----TE--------------|-BM|--o|?T---T------B---T----
-------B----EM-B-------oM-|o--|---------|------EE-E--------B--X----oXEE-E--T-E--------M?-ET-----M---?-?--X-?M--B---B--E-----o-ME-E----o-E|------B-----o-|X--M----MoB--?|--------|-T-----B--ME-----------
-o------|-----T------------M--o----------------?---|---?---?--------B-o-----|--------X------o------EE--E----|-E-X--X--------------BT|-M---?--|-X|-----E-M-----X----E--Xo-o------o-o-M-------|-----E----v
----B--------T-----?--|---|-X-----TE--?|----------o-T---?-----------T---T-------o----------X-E-E-?-B-o?---------E--T--E-----E-?-------MET-|-----?-?-o-oT-B|M-------X------?-------XM-E-?----------T----f
----------TX-------M-E--|---M-M--X-E---------X----M|--------E---|--X--------E---M--M-X--------X----M-----M----T---------T-----?B---BX---------M--------o-M----------E-T--T-?------M-|------|---X--XBE--f
----o-oM--MT-M-M----M-E-------?---|----------B---o------M--B-?-XoM----------------oB-?|T----E-----EM--T|-----T-M-MX---B--M------------o|----------o--?X---X--B---E-----M--X-----?-?--TT--E-------X--|-?f
---------M-?o---o?-B----E------B--E--T--X----?--E----|-M---oo----------oM--T-----?-------E--M|---------B-----?---M-----E-?-------M---T-----------------------T-------------|--X?-----------X|----------f
-X---X---B|-----E-o-E----?-M--?M-------B--B---E---M--?----------E-o-o--TXE---o-o--|--|-E--MT??-X----o-------T-----?----o-------T------?--------oE-T--------B-E----------------X--X----E--o-?-?-----B---f
-------------M---XBo--X--------X-B---T-----------T-M--B----------T-----------E-T-------------T-----MB------B----o-----X----|--TE--M-E--?----|---|--E----B--?--X-----E-M--T|----TB-------------T|X-o----f
mB--E-?-|---MX--X-T-M-----o-?EE-------|-o----o?-M-?-oo-----TBT|-----E-E-----TB-----BMEEX---|---E--|----X------?-E-----T----|---BM----------X-BX------E|--------E---T-------B---?-oB--?EEo-------T----o-X
XXXXXXMXXXXXXXXXXXXXXXXXXXXXXXXXXXXXXXXXXXoXXXXXXXXXTXXXXXXXXXXXXXXXXXXXXXXXXXXXXXXXXXXXXXXXXXXXXXXXXXXXXXXXXXXXXXXXXXXXXXXXXXXXXXXXXXXXXXXXXXXXXXXXXXXXXXXXXXXXXXXXXXXXXXXXXXXXXBXXXXXXXXXXXXXXXXXEXXXX
