-----------------------------------------------------------------------------------------------------------------------------------------------------------------------------------------------------------
--oo--------------------------o---------------------------------o-o-------------o---X-----------------------------------------------------------------------------------o----------------------------------
---------------------------------------------------X-?------o---------------------------------BBBBBBBBBB----------BBBBBB-----------------------------------------------------------------------------------
--------------------------------o--------------------------------BBB-------------------------------------------------------------o-------------------------------------------------------X-----------------
------------------------X-------------------------------------------E-----o----------E---------------------o---------------------------X-----o------------------------X------------------------------------
--------------X-----B---o-----BBB-----------o--XXXX--------------XXXXX---------BBBBBBB------------------BBBB-X----------------------BBBo---------?-B--------------------------B------X---------------------
---------------------------------------------------------?----------------------------------BBBBBBBBo---------BBBBB--BXB------------------------------------------XX?XX-----------------o------------------
------------------------------BBBBBBB-------XXXX----------------XB?B-----------BBBBB---------------------------------------????----------------------oBBBB---------------------------------------------v---
-------------------------------------------------------------------------------E----------------------------oXBB--------------------o------------------------------------XXXXXXXX-----o-X--------------f---
-----------------------------------------------TBBB---------B-BBBBBB--------??BB------BBBBBBBB----------XXXX----o----BBB------BB---B?BBBBBB---o---B-----------BBBXBXBB---------------------------------f---
-------------E-E------------------------------E|--------------------E----------------E-------------------------o--------------------------------------------oX-----------------------------------------f---
-----------BBBBB-------------XBBBB-----BBBBBXBB|BBBBB----???????-BBBBB----BBBBB--BBB-BBBBBBXo---------BB--B?BBB-----????--BBBBB--BBB----TBBBBB-T--X--B-BBXX?--BBTB----BXBBB---------o------------------f---
--------------------o---oo---------------------|---------------------------------------o-----T--X---o--o-------------------------o------|------|---------------o|-----------------X--------------------f---
---------o-------------------o----------------o|------------------------------o--o-----------|------------------------------------------|------|----------------|------------------------------------o-f---
m-E------E---E-E-E------E--------EE-----E----E-|----E-E---E----E---------------E-EE-EE---EE--|---E---EE-------E---E-----E--E------------|-E----|----------E-E---|----------------E-----E---------------X---
XXXXXXXXXXXXXXXXXXXXXXXXXXXXXXXXXXXXXXXXXXXXXXXXXXXXXXXXXXXXXXXXXXXXXXXXXXXXXXXXXXXXXXXXXXXXXXXXXXXXXXXXXXXXXXXXXXXXXXXXXXXXXXXXXXXXXXXXXXXXXXXXXXXXXXXXXXXXXXXXXXXXXXXXXXXXXXXXXXXXXXXXXXXXXXXXXXXXXXXXXXX
