-----------------------------------------------------------------------------------------------------------------------------------------------------------------------------------------------------------
-------------------------------------o----------------------------------------------------------------o-------------------------------------------X--------------------------------------------------------
--------B--------------------------------------------------------------------------------------------------------------------------------------------------------------------------------------------------
-----------------o-------------------------------------------------------o------B--------------------------------------------------------------------------------------------------------------------------
-----------------------------------------------------------------o------------------------------------------------------------------------------------------------------------------X------o----?----------
---------------------?----------o-o------------------------------------------------------------------------------------------------------------------------------------------------------------------------
---------------oo------------------------?----------------?---------------------o----------X---------------------------------------------------------------------------------------------------------------
-----------o-------------------------------------------------------------------------------------------?-----------------------------------------------------------------------------------------------v---
----------------------------XXXXXX---------------------------XXXXXXX-------------------------------------X------------------X-------------X-----------o------------------------------------------------f---
------------------------------------------------------------------------o-----------XB-------------------------------------?????---------------------X-?---------X--------X----------------------------f---
-----------------------------------XXXXXX-----------------------------XXXXXXXX---------------------------------------------------o--------XXXXXXX----------------------------------------------------o-f---
---------------------------o------------o---XXXX----------------------------------------------------T------------XXXX---------------------------------o-------------XXX-----------------------o--------f---
--X---------------------------------T---------------------o-----------------------------------------|---------------------------------------------------------------XXX----B---------------------------f---
------------------------------------|---------------------------BBBBBXBB----------------------------|---------------------------------------------------------------XXX---------------o----------------f---
m------E-----------------------E----|-------------------------------------E-------------------------|------------------------E----------------------------------------------------------------E----E---X---
XXXXXXXXXXXXXXXXXXXXXXXXXXXXXXXXXXXXXXXXXXXXXXXXXXXXXXXXXXXXXXXXXXXXXXXXXXXXXXXXXXXXXXXXXXXXXXXXXXXXXXXXXXXXXXXXXXXXXXXXXXXXXXXXXXXXXXXXXXXXXXXXXXXXXXXXXXXXXXXXXXXXXXXXXXXXXXXXXXXXXXXXXXXXXXXXXXXXXXXXXXX
