-----------------------------------------------------------------------------------------------------------------------------------------------------------------------------------------------------------
-----------------------------------------------------------------o----------------------------------------------------------------------------------------------------------------o------------------------
-----------------------------------------------------------------------------------------------------------------------------------------------------------------------------------------------------------
-----------------------------------------------------------------------o-----------------------------------------------------------------------------------------------------------------------------------
------------------------------------------X------------------------------------------------------------o---------------------------------------------------------------------------------------------------
-------------------------------------------------------------------------------------------X---------------------------------------------------------------------------------------------------------------
------------o-------------------------------------------X----------------------------------------------------------------------------------B---------------o-----------------------------------------------
---------------------------------------------------------------------------------------------------------------------------------------------------------------o--------------------------o------------v---
--------------------------------------------------------------------------------T-------o------------XXXX----------------------------------------XXXXXXXX----------------------------------------------f---
---------------------------B------------------o------------??????X--------------|--------------------------????----------------------------------------------------------------------------------------f---
---------------------------------------------XXX--T------------------------T----|-------XX????????-----------o---------------X?X------XXXXXXXX---T-----------------------------------------------------f---
--------------------------------------------------|------------------------|----|--------------------------?-------------XXXX--------------------|-----------------------------------------------------f---
--o------------------XXXXXXXX------------XXXX-----|------------------T-----|----|?XX-------------XXXXXXXX---XXXXXX-----------------------o-------|----------------------X------------------B-----------f---
------------o-------???------------------------o--|------------------|-----|----|-------------------------------------------------XXXXXXX--------|-----------------------------------------------------f---
m-------------------------------------------------|------------------|-----|----|---------------------E-----------------E---------------------E--|-E------------------------------------------------E--X---
XXXXXXXXXXXXXXXXXXXXXXXXXXXXXXXXXXXXXXXXXXXXXXXXXXXXXXXXXXXXXXXXXXXXXXXXXXXXXXXXXXXXXXXXXXXXXXXXXXXXXXXXXXXXXXXXXXXXXXXXXXXXXXXXXXXXXXXXXXXXXXXXXXXXXXXXXXXXXXXXXXXXXXXXXXXXXXXXXXXXXXXXXXXXXXXXXXXXXXXXXXX
