-----------------------------------------------------------------------------------------------------------------------------------------------------------------------------------------------------------
-------?----------------------o--------------------------------------------o----------------o----------------------?---------------------------------------------------------------------------------------
--------------------------------------------------------------------------------------------------------------------------------------------------------------------------------------------o--------------
---------o---------------------------------------------o-----------------------------------------------------------------------------------------------------------X------------------------X--------------
-----------------------------------X------------------------------------BBB----o------------------B----------?---o------------------------------X----------------------------------------------------------
--------------Xo----------------o------------------------X--------------------------------------------------X--------------X-----------B--------------X----X----o----X-----------------------?-------------
------------o-------------------------o-------o---------o------------------------?------o-----------------------------------------------------o------------------------------------------------------------
--------B-----------------------------X--------------------------------B----------------------------------X-BBBBBBB----------------X----------------------------------------------------B--------------v---
------------------------------------o---------------?----------------------------------------------T--o--------X--------------------------------------T--X---------------------------------------------f---
--------------------------------------B----------o-------------------------------------------------|----------------------------------------------o---|------X---------------------X-------------------f---
-------------B-------------------------------------------------------------------------------------|--------o------------------------?-o--------------|------------------o---o----X-----------------o--f---
----------------------T-------------------BBBBBBB---XXX--X-BBB-BB---BBBB-B-XBBBB------------------B|B-BB-BBXBBX-------BBB-----------BBB-----------?B??|??------o----------------------o----------------f---
----------------------|-----------------------o----o--------------------T---------------------X----|----------------------T--------o------------------|--------------------------B--B------------------f---
----------------------|-----------------------------------------o-------|--------------------------|-----o----------------|--------------------o------|------------------------------------------o-----f---
m------E--------------|------------------------------o------------------|--------------------------|---------------EE-----|-------E-------------------|-----------------E------------------------------X---
XXXXXXXXXXXXXXXXXXXXXXXXXXXXXXXXXXXXXXXXXXXXXXXXXXXXXXXXXXXXXXXXXXXXXXXXXXXXXXXXXXXXXXXXXXXXXXXXXXXXXXXXXXXXXXXXXXXXXXXXXXXXXXXXXXXXXXXXXXXXXXXXXXXXXXXXXXXXXXXXXXXXXXXXXXXXXXXXXXXXXXXXXXXXXXXXXXXXXXXXXXX
