-----------------------------------------------------------------------------------------------------------------------------------------------------------------------------------------------------------
------------------------------------------------------------------------------------------------------------o----------------------------------------------------------------------------------------------
---------------------------------o------o---------------------------------o------------------------------------------o-------------------------------------------------------------------------------------
-X---------o------------------------------------------B--------------------------------------------------------o---------------------------------------------o-o-------------------------------------------
--------------------------------------------------------------------------------------------------------------------?-------------X--------------------------------------------o---------------------------
-------------------------------o------------------------------------------------------------------------------------------------o--------------------------------------------------------------------------
------------------------o-----------------------------------o----------X---------------------------X-----------------------------------?-------------------------------------------------------------------
-------------------------------------o-----------------------------------------------X-------------------------------------------------------o--------------------------------------------o------------v---
-----------------XXX-------------------------------------------------------------------------------------------X-XX--X----------------------------XXXXXXX-----------XXXX-----------X-------------------f---
------------------------------XXX--------------------------------------------o---------------------------------------------------------------XXB-XXXX-XX-----------------------------------------------f---
--------------------------------------XXXXXXX--------o-------------------------------------T---XXX?XX-------------XX-X--X------------o-----------------------------------------------------------------f---
---------------B--o------------------------XXX----------------XBXXXXX---------------?-?----|?----------------------------------------------XXX-XX------------X-----------------------------------------f---
---------------------------------------------XXXXX-----------------------------------------|----------------o------------------------------------------------------------------------------------------f---
--X-------------------------------------------o-----B-------------XXXXXXXXXXXX-------------|---------------------------------------------------------------------BBBBBBBB--------------------o---------f---
m---------------------------------------------------------------------E--------------------|------E-----E----------------------------------------------------------------------------------------------X---
XXXXXXXXXXXXXXXXXXXXXXXXXXXXXXXXXXXXXXXXXXXXXXXXXXXXXXXXXXXXXXXXXXXXXXXXXXXXXXXXXXXXXXXXXXXXXXXXXXXXXXXXXXXXXXXXXXXXXXXXXXXXXXXXXXXXXXXXXXXXXXXXXXXXXXXXXXXXXXXXXXXXXXXXXXXXXXXXXXXXXXXXXXXXXXXXXXXXXXXXXXX
