-----------------------------------------------------------------------------------------------------------------------------------------------------------------------------------------------------------
---------------------------------------------------------------------------------------o--------------------------------X----o----o------------------------------------------------------------------------
------------------------------------?---------o-----------------------X---o------------------------o----------------X--------------o----------------------------------------------o------------------------
----------------------------------------o-----------------------?-----o------------------------------------------------------o---------X---------------------------------------------------------X---------
-------X------------------o---------o----------------------------------------------------------------?-----------------------X----------o--------o------------------B--------------------------------------
----B----------------------------------------------XB---------------o--------BBBBB--------X-----------------------------------------o----------------X------------------?----------------------------------
--------------------------------------------------X--------------------------------------------------------------------------------------------------------------------------------------------------------
---------------------------------------------------?-------------------o---B--X----------o----B---o-----------BBBBBB--------------E--------------------------------------------B-----------------------v---
-------?----------?-------------------------------------------------------------------X---------------------------X-----o----BBXBBBB?----o-----BBB--------------------------o--------------------------f---
--------------------------o-----------------BBBB----T-----------------------o--T-----------------------------------------------------------------------------------------------------------------------f---
----X--------------o--------------------------o-----|--------------------------|-------o--------------------------------------------------------------------------------o-----------------o------------f---
------------------XB---------BB-X--------?----------|B-------------?X????-BB--B|BB---B----XXXX---------T-B-BBBXXX-----BBBB-BTBBB------------B?BBBB------------------B-BXBBBB--------o------------------f---
-----------------------o----------------------------T--------------------------|---------------o------T|--------------------|-----T-------------------T---------------------X--------------------------f---
----------------------------------------------------|--------------------------|--------------X-------||--------------------|-----|-------------------|---o------------------------------------o-------f---
m--------------------------------------------E------|--------------------------|E--------------E------||--------------------|-----|-------------------|------------------------------------------------X---
XXXXXXXXXXXXXXXXXXXXXXXXXXXXXXXXXXXXXXXXXXXXXXXXXXXXXXXXXXXXXXXXXXXXXXXXXXXXXXXXXXXXXXXXXXXXXXXXXXXXXXXXXXXXXXXXXXXXXXXXXXXXXXXXXXXXXXXXXXXXXXXXXXXXXXXXXXXXXXXXXXXXXXXXXXXXXXXXXXXXXXXXXXXXXXXXXXXXXXXXXXX
