-----------------------------------------------------------------------------------------------------------------------------------------------------------------------------------------------------------
----------------------------------------------------------o-------------------------o----o------------------------X-----------------------------------------------o----------------------oB----------------
---------------------------------------------------------------------------------------------------------------------------------o----------o---------------X-------o--------------------o-----------------
------------------------------------------------X---B------B-----------X-----------------------------X--------------------------------------------------------------------------------o--------------------
------------------------------------------------------------------X-------------------------------------o-----------------o------------------------------------------------------------o-------------------
----------------------------------------------------B---------------------------------------------o-----------o----X---------------------------------------------------------------------------------------
---X----o----B------------------?------------------------------------------------o----------------------------------------------------------------------------X--------------------B---o-------------------
-------------------B-------------------------------------------------------------------------------X---oo----?--------------o-------B-----X-----------------------------------------?------------------v---
-------------------------------------------------------------X------?------B-----------------------------------------------------------------------------------------------X---o-----------------------f---
------------------X------------------?------------X---------o-----------------------o-----------T-----------------------X--------------------------------o---------------------------------------------f---
--------------------------------------------o----------------------o--------------------o-------|-------------------------oB---------------------------------B-----------------------------------------f---
---o-----------------X---o-----------------T-------o-----------?---------------------------T----|---------------------------------------T-------------------------------?-----o----B----------X--------f---
-------------------------------------------|-o---------------------o---o-T-----------------|----|o---------------T----------------------|----------------------T-------------o-------------X------o----f---
---------------------------o--oX-----X-----|---------------X-------------|-----------------|----|----------------|----------------------|----------------------|---------o-----------------------------f---
m----------------------------------------E-|-----------------------------|---------E-------|----|----------------|----------------------|-----------------o----|---------------------------------------X---
XXXXXXXXXXXXXXXXXXXXXXXXXXXXXXXXXXXXXXXXXXXXXXXXXXXXXXXXXXXXXXXXXXXXXXXXXXXXXXXXXXXXXXXXXXXXXXXXXXXXXXXXXXXXXXXXXXXXXXXXXXXXXXXXXXXXXXXXXXXXXXXXXXXXXXXXXXXXXXXXXXXXXXXXXXXXXXXXXXXXXXXXXXXXXXXXXXXXXXXXXXX
