-----------------------------------------------------------------------------------------------------------------------------------------------------------------------------------------------------------
------------------------o--------------o--------------------------------------o---X------------------------------------------------------------------------------------------------------------------------
--------o-------------------------o-----------------------------o-------------------B----------------------------------------------------------------------------------------------------------------------
-----------?------------------B---?---o-------------------------o----------o---------------------------------------------------------------------------------------X---------------------------------------
--------------------------------------------------------------------------X------------------X--------------X-X----X---------------------------Bo-------X---B----------------------------------------------
----------------------------o------------------------------X--------X--------------X----?-----------------------------X-XXXX------X---------------------------o------------X-------X-----------------------
-----BX-----------------o------------------o--------------------------------------------------------------------------o------------------------------------------------------------------------------------
-X-----o-----------------------------------------------------------------------o--------------------------X-XX----XXX-XX-----------------------XXX--------------o----------------------------------o---v---
--------------------------------------------------------XXX----------------------------------------------------------------------------------------o---B---------------????X---------------------------f---
-------------------?----o------B------------------o-X---------BBXBBBB----------------X-B----------------------------------X-----------------------------------o---------------------o------------------f---
--------------------------------------------------------------------o---------------------------------------------------------o------------------------------------------------------------------------f---
--X--------------o-------XXXX----XX-XX------------XX---XXX------XXXXX---------o-------XXX------X-XXXB--XX-X-------X---XXX---------------------oXXX--------------????X??X-------------------------------f---
----------o------------------o-------------------------------o-----------------------------?-----------------------------------------T------------------o--------------------------------X--o----------f---
-------------o-----------------------------------------o--------------------------------------------------o--------------------------|----------------------------X-o---o--o--X------------------------f---
m--------------------------------------------------------------------------------------------E---------------------------------------|-----------------------------E------------------------------E----X---
XXXXXXXXXXXXXXXXXXXXXXXXXXXXXXXXXXXXXXXXXXXXXXXXXXXXXXXXXXXXXXXXXXXXXXXXXXXXXXXXXXXXXXXXXXXXXXXXXXXXXXXXXXXXXXXXXXXXXXXXXXXXXXXXXXXXXXXXXXXXXXXXXXXXXXXXXXXXXXXXXXXXXXXXXXXXXXXXXXXXXXXXXXXXXXXXXXXXXXXXXXX
