-----------------------------------------------------------------------------------------------------------------------------------------------------------------------------------------------------------
-----------------------------------------------------------------------------o---------------------------o-----------------------------------------------------------o-------------------------------------
-----------------------------------------------------------------------------------o-----------------------------------------------------------------------------------------------------------------------
----B------------------------------o-----------------------------------------------------------------------o-----------------------------------------------------------------------------------------------
----------------X---------------------------------X-----------X-----------o--------------------------------------------------XXXX---------------o--------------------------------o-------------------------
---X------------------------o----------------X---------------------------------X------------------------------------X-------X--------------------------------------------------?---------------------------
-o-------------------------------------------------------------o--------------------XXX---------------X--------------------------------o----------------X-o-X-----------X-----------------------?-----?----
--------------------------------------------------B----------------------XXXXXX------------------------------------------XXXXXX--------------B------------------------------------------------o--------v---
-----------?-------------------------o------------o-------------------------------XXX------------X-----------------------------------------------X--------?------------------X-------------------------f---
-------------------------X-------------------------o------------------------??????------X--------------X----------XXXXXX-------------------------------------------------------------------------------f---
------------------------------------o--------------XXBXX------------------------------------------------------o-----------------------------------------------X----------------------------------------f---
-----------XXX----XXXX-o---------TXX---------------?XX--------XXX----BBB-BBBBBB---o-------XXXX---------XXXX---XXXXX?XXX---XXX----------o-----?-----------------B----XXX?XXXXX------------------o-------f---
----o----------------------------|---------X-o------------------------------------------T-------------------------------------------------------T----X----o----------------------?-------------?-------f---
---------------------------------|----------------------------X-------------------------|-------------------------------------------------------|------------------o-----------------------------------f---
m-E--------E---E-----------------|--E-----------------------E---------------------------|-----------------------E----------------------o--------|-----------E------------------------------------------X---
XXXXXXXXXXXXXXXXXXXXXXXXXXXXXXXXXXXXXXXXXXXXXXXXXXXXXXXXXXXXXXXXXXXXXXXXXXXXXXXXXXXXXXXXXXXXXXXXXXXXXXXXXXXXXXXXXXXXXXXXXXXXXXXXXXXXXXXXXXXXXXXXXXXXXXXXXXXXXXXXXXXXXXXXXXXXXXXXXXXXXXXXXXXXXXXXXXXXXXXXXXX
