-----------------------------------------------------------------------------------------------------------------------------------------------------------------------------------------------------------
-----------------------------------------------------------------------------------------------------------------------------------------------------------------------------------------------------------
---------------o-----------------------------------------------------------------------------------------------------------------------------------------------------o-------------------------------------
------------------------------------------------------------------------------o----------------------------------------------------------------------------------------------------------------------------
-----------------o-----------------------------------------------------------------------------------------------------------------------------------------------------------------------------------------
---------------------------------------------------------------------------------------------------o--------------------------------------------------------------------------------------o----------------
----------------------------------------------X--------------------------------------------o-------------------------------------------------X-------------------------------------------------------------
-----------------------------------------------------------------------------------------------------------------------------------------------------------------o-------------------o-----------------v---
-----------------------------------------T------------------XXXXBXXX--XXXXXXXXXX---XXX--------------o-------------------------XXXX----------------------XXXXXXX----------------------------------------f---
---------------------------XXXXXX----X---|--------------------------------------------?----------------------------------------------------------------------XXXXX-------------o-----------------------f---
-----------------------------------------|---------------------------------------------------------------XXXXXXXXXXX----------------------XXX----------------------------------------------------------f---
-----------------------------------------|-------------------------------------------B------------------------------------XXXB------------------------------------X------------------------------------f---
-----------------------------------------|----------------------------------------------B----------------------------------------------------BXXXXX----------------------------------------------------f---
------------------------XXXXXXXX--XXXXX--|o---------------------------------o--------------------------------------------------------------------------------------------X-----------------------------f---
m----------------------------------------|-------------E------------------------------------------------------------------E-----------------------------E----------------------------------------------X---
XXXXXXXXXXXXXXXXXXXXXXXXXXXXXXXXXXXXXXXXXXXXXXXXXXXXXXXXXXXXXXXXXXXXXXXXXXXXXXXXXXXXXXXXXXXXXXXXXXXXXXXXXXXXXXXXXXXXXXXXXXXXXXXXXXXXXXXXXXXXXXXXXXXXXXXXXXXXXXXXXXXXXXXXXXXXXXXXXXXXXXXXXXXXXXXXXXXXXXXXXXX
