--------------------------------------------------------------------------------------------------------------------------------------------------------------------------------------------------------------------
-------------------------------------------------------------------------o-----------------------o------------------------------------------------------------------------------------------------------------------
-------------------------o----o-----o------------o------------------------o--B---X---X----------BBBB-------BB--B--B------o--o--------o----------------------------------------------------------------X-------------
------------------------------------------------------o-----------------------------------------------oo------------------------o--BBBX---------------------------------o----X---------o----------------------------
---o-X--o--------------------------------------------------------------o-----------------------------------X--BB---------------------oB------X------------------------B-----------------X---------------------------
--o-----------------?--o----?X------------------o---XX--B-B--X----------o-------------B-o----XX-X---------------B-XX---X--X?X-------o---------BB?-B--------------X----o------------X--------o-----------------------
-----X---X----------X------------------?---------B-------o-------------o----BBB-----o-----------------o--?B-B--------o-----------o----o-----??------------------BBBB--B-----------o---------------------------------
-----o--------------o-----------------------------------o--------XB--X-----o---BB---B---?-----------------------------o--X-B-----B?B--------------------------o--------o-------------------------------v------------
--------------------X--T---------------B------------XX-------------------------------???--X-BBB-----?---o-------B----o----------------------BB---------------X--X---X----------------------------------f------------
------------------X----|----------------------oBBB--------X------XXX-o---------B-------------o------o-----------B----XBBB----B----o-----B--------------------T------------o----X---------------X-------f------------
-----------------------|--------------------------------o---------T----------o--o---------------X----------------B-----T-----o-----------T-------------------|-----------------------------------------f------------
---------o----?BBB----B|B----T--XXXXX------B--?-X--B-------------B|B----T-BB-B-----------BBB----B-B----BBo------X-----?|-----X-----???BBB|?X?-B-XXB-----BB-BB|o-----------------------------------o-o--f------------
------------o----------|-----|-----------------------------------T|-----|-----o-----------o---------X---------o--------|o-----B----------|---------B---T-----|T----o-----o-----------------o-------X---f------------
-----------------------|-----|------------------------o----------||-----|-------------o-------B----------------------o-|-------o---------|-------------|-----||----X--o--------?------------o--?-------f------------
m----------------------|-----|-------------E------------------E--||-----|-------E---------E----------------------------|-----------------|-------------|-----||---E----------------------E-------------X------------
XXXXXXXXXXXXXXXXXXXXXXXXXXXXXXXXXXXXXXXXXXXXXXXXXXXXXXXXXXXXXXXXXXXXXXXXXXXXXXXXXXXXXXXXXXXXXXXXXXXXXXXXXXXXXXXXXXXXXXXXXXXXXXXXXXXXXXXXXXXXXXXXXXXXXXXXXXXXXXXXXXXXXXXXXXXXXXXXXXXXXXXXXXXXXXXXXXXXXXXXXXXXXXXXXXXX
