-----------------------------------------------------------------------------------------------------------------------------------------------------------------------------------------------------------
-----------------------------------------------------------------------------------------?-----------?o----------------------------------------------------------------------------------o-----------------
---------o--------------------o---------------------------------X------------------o--------------------------o-----------------------------o-----------------------o--------------------o-----------------
-----------------o---X----------------------------------------o---------------------------------o------------o------------------------------------------------------------------------o--------------------
-----o---------------------?-----------------------------X------------------------------------------------------------------------B---------------------o------------------------------o-------------------
----------X-----------------------------------------o------------------------X----------B---------------------------------------------o--------------------------------------------------------------------
------o--o----X-----o---------------------------o-------X--------------B-------------------------------------?--------------X---------------------------------X---------------------X--o-------------------
-------------------B------o-o--------------------X-------------X----------------------------------------?---------------------------------X-----------------------------------------?------------------v---
--------------------------------------------------------------------------o------?---------------X-----------------o----------oT-------------------------------------------X---o-----------X-----------f---
------------------B--------------------------?--------------X-------------------------------------o------------o---------------|---o--------------------------------------------B----------------------f---
-----------------------------X----------o------------------------------------?-------------------------------------------------|-----------------------------B-----------------------------------------f---
---------------------X---------------T----------------------------o------------------X-----o---------------------------------T-|---------------------------------o------?-----o----B-------o--X--------f---
-------------------------------------|---------------------------------------------------------T-------------------------B-X-|-|-------------------------------T-------------o-------------X-----------f---
-------------------------------------|--o-------------------------------------------------o----|-----------o---------?-------|-|-------------------------------|---------o-----------------------------f---
m-o----E----------------------E------|--------------------E--------------E------------E--------|-----------------------------|-|--------------------------o----|---------------------------------------X---
XXXXXXXXXXXXXXXXXXXXXXXXXXXXXXXXXXXXXXXXXXXXXXXXXXXXXXXXXXXXXXXXXXXXXXXXXXXXXXXXXXXXXXXXXXXXXXXXXXXXXXXXXXXXXXXXXXXXXXXXXXXXXXXXXXXXXXXXXXXXXXXXXXXXXXXXXXXXXXXXXXXXXXXXXXXXXXXXXXXXXXXXXXXXXXXXXXXXXXXXXXX
