-----------------------------------------------------------------------------------------------------------------------------------------------------------------------------------------------------------
---o-------------------------------o--------------------------------------X----------------------------------------------------------------------------------------o---------------------------------------
-----------------------------------------------X-------------------------------------------------------------------o---------------------------------------------------------------------------------------
--------------------------------------oo-------------------------------------------------------------------------------------------------------------------------------------------------------------------
----------------------------------------------------------------------------------------------------------------------XXXXXXX----------o--------------------------------------o----------------------------
-----------------------------------------------------------------------o-----------------------------------------------------------------------------------------------------------------------------------
----------X----------------------------------------------------------o-----------------------------XXXX----------------------------------------------------------o-----------------------------------o-----
--------------------------------------------------------------------------------------------XXXXXXX-----------------XXXXXXXX-------------?--o----------------------------------------------------------v---
------------------------------X--------------------------------------------?---------------------------------------------------------------------------------------------------------------------------f---
-------------------------------------------------------------------------------------------------------------------------------------------------------------------------------------------------------f---
-------------------------------------------------------------------------------------------------------------------------------------------------------------------------------------------------------f---
--o--------------------------XXXXXX-XX---X-XXXo------?????---o--XXX---XXXXXX---BBXBBBXB---XXX------------o----------XXXXX-o--------XXX---------------------BBBBBBB-----------o-------------------------f---
---------------------------------------------------------------------------------T---------------------T------------------------------------------------------X--------------------------------------o-f---
---------------------------------------------------------------------------------|---------------------|-----------------------------------------------------------------------------------------------f---
m-----------------------------------E--------------------------------o-----------|-------------------E-|--------------------------------E--------------------------------------------------------------X---
XXXXXXXXXXXXXXXXXXXXXXXXXXXXXXXXXXXXXXXXXXXXXXXXXXXXXXXXXXXXXXXXXXXXXXXXXXXXXXXXXXXXXXXXXXXXXXXXXXXXXXXXXXXXXXXXXXXXXXXXXXXXXXXXXXXXXXXXXXXXXXXXXXXXXXXXXXXXXXXXXXXXXXXXXXXXXXXXXXXXXXXXXXXXXXXXXXXXXXXXXXX
