--------------------------------------------------------------------------------------------------------------------------------------------------------------------------------------------------------------
------------X--------------------------------------------------------------------------------------X----------------------------------------------------------------------------------------------------------
-------------------o----------------------------------o-------------------------------o---X--------------o----------------o-----------------------------------------------------------------------------------
---------------------------------------o---------------------------------------------------------------------------------------------------------------------X---------o------------------------------?-------
-------------------------------------------X-------------------------------------------------------o-------------------------------------------------------------------------------------------o--------------
----------o----------------------------------------------------o-----------------------o------------------------------------o-----------------X-------------o----------------------------------------X--------
-----------------------------------------------------------------------------------------------------------------------------------o--------------------------------------------------------------------------
-------?--------?-----------------------------------------------------------------------------------X-----------------------------------------------X-------X----------------------X------X------------v------
------------------------------?X??------------XXXXXX----------------------------B-----------------?------------------------------------?---------o-----------------------------------X-----------------f------
---------------o-------------------------B----------------XXXXXXX------T----------------XXXXXXXX--------------?-------XXXX----o----------------o-XXXX------------------o--------------?----------------f------
-----------------------XXX---------------------------------------------|---------------------------------------------------X----o---XXXXXX-XXX-----------------------o---------------------------------f------
------------------oo-XXX---------------------------------X-------------|--------------------------------------------o-----------o------o---------------------------------------------------------------f------
---------------------------------------------------------o-------------|----------------------------XXXX------o---------------------------------------------?------------o----------------B------------f------
---------------------------XXX--XXXXXXX------------X---X-----XBX?------|-----------------------XXXX-----XXXXXXBXXXX?XX--------XXXXXX----------------o---------X----------------------------------------f------
m----------------------------------------E-----------------------------|------E--E---------------------------------------------------------------------------------------------------------------------X------
XXXXXXXXXXXXXXXXXXXXXXXXXXXXXXXXXXXXXXXXXXXXXXXXXXXXXXXXXXXXXXXXXXXXXXXXXXXXXXXXXXXXXXXXXXXXXXXXXXXXXXXXXXXXXXXXXXXXXXXXXXXXXXXXXXXXXXXXXXXXXXXXXXXXXXXXXXXXXXXXXXXXXXXXXXXXXXXXXXXXXXXXXXXXXXXXXXXXXXXXXXXXXX
