-----------------------------------------------------------------------------------------------------------------------------------------------------------------------------------------------------------
------------------------------------------------X----------------------------------------------------------------------------------------------------------------------------------------------------------
-----------------------------------------------------------------------------------------------------------------------------------------------------------------------------------------------------------
----------------------------------------------------------------------------------------------------------------------------X------------------------------------------------------------------------------
-----------------------------------------------------------------------------------------------------------------------------------------------------------------------------------------------------------
----------------------------------------------------------------------------------------o------------------------------------------------------------------------------------------o-----------------------
-----------------------------------------------------------------------------------------------------------------------------------------------------------------------------------------------------------
------------------------------------------------------------------------------------------------------------------------------XXXXX-------------------XXXXXXX---------------------X--------------------v---
-----------------------------------XXXXXX----------------------------------------------------------------------------------------------XXXXXXX---------------------------------------------------------f---
-------------------------------------------------------------------------------------------------------------------------------------------------------------------------------------------------------f---
-----------------------------------------o----o-------------------------E------------------------------------------------------------------------------------------------------------------------------f---
------------------------------??????-----XXXXXX--BBB----XX-----------XXXXXXX-------???----------XBXXXX-------------------XXXXXX-------XXXXX------??????--------????????--BBBBB-------------------------f---
------------------------------------------------------------------------T---------------------T----------------------------------------------------------------------------------o---------------o-----f---
---o--------------------------------------------------------------------|---------------------|--------------------------------------------------------------------------------------------------------f---
m-------------------------------------E---------E-----------------------|---------------------|--------------------------------------------------------------------------------------------------------X---
XXXXXXXXXXXXXXXXXXXXXXXXXXXXXXXXXXXXXXXXXXXXXXXXXXXXXXXXXXXXXXXXXXXXXXXXXXXXXXXXXXXXXXXXXXXXXXXXXXXXXXXXXXXXXXXXXXXXXXXXXXXXXXXXXXXXXXXXXXXXXXXXXXXXXXXXXXXXXXXXXXXXXXXXXXXXXXXXXXXXXXXXXXXXXXXXXXXXXXXXXXX
