-----------------------------------------------------------------------------------------------------------------------------------------------------------------------------------------------------------
-----X--------------------------------------------------------------------------------------------------------------------------------------------------o--------------------------------------------------
------------------------------------------------------------------------------------------------o----------------------------------------------------------------------------------------------------------
--------------------------------------------------------------------------------------o----------------------------o---------------------------------------------------------------------------------?-----
-----------------------------------------------------------------------------o-----------------------------------------------------------------------------------------------------------------------------
---------------------------------------------------------------------X-----------------------------------X-------------------------------------------------------------------------------------------------
-------------------------------------------------------------------------------------o---------------------------------------------------------XXX---------------------------------------------------------
---------------------------------------------------------------o------------------XXX----------------------o----------------------------------------------------------------------------------o--------v---
---------------------X--------------------------------------T------------------------------------------------------------------o-------------------------------------------------o---------------------f---
-----------------------o------------------------------------|-o----------------------------------------XXX?XXXX-------------------------------------------------------o--------------------------------f---
------------------------------------------------------------|------------------------------------------------------------------------------BBBBB----------------o--------------------------------------f---
----------------------------------XXX--------XXX----------BB|BBB---XXXXXXXXXXXXX--B??XXXXX-----------T-XXXXXX-XXXXXXXBBB-------BBBBBBBBXXXX-----------?----XXXXXX--------------------------o-----------f---
----------------------?------o------------------------------|----------------------------------------|----------------------------------------------------------------o--------------------------------f---
-----------------------------------------o------------------|----------------------------------------|----------------------------------------------------------------------------------------B--------f---
m---------------------------------E-------------------------|----------------------------------------|-------------------oE----------------------------------------------------------------------------X---
XXXXXXXXXXXXXXXXXXXXXXXXXXXXXXXXXXXXXXXXXXXXXXXXXXXXXXXXXXXXXXXXXXXXXXXXXXXXXXXXXXXXXXXXXXXXXXXXXXXXXXXXXXXXXXXXXXXXXXXXXXXXXXXXXXXXXXXXXXXXXXXXXXXXXXXXXXXXXXXXXXXXXXXXXXXXXXXXXXXXXXXXXXXXXXXXXXXXXXXXXXX
