-----------------------------------------------------------------------------------------------------------------------------------------------------------------------------------------------------------
------------------------------------------------------------------------------------------------------------------------o----------------------------------------------------------------------------------
--------------------------------------------------------------------------------------------------------------------------------------------------------------------------------------------------o--------
-----------------------------------------------------------------------------------------------------------------o----------------------------------------------------------------o------------------------
-----------------------------B------------------------------?----------------------------------------------------------------------------------------------------------------------------------------------
----------------------------------------------------------------------------------------------------------X--------------------------------------X------------------------X--------------------------------
----------------X--------?------------------------o--------------------------------------------------------------------------------------------------------------------------------------------------------
-----------------------------------------------------------------X---------------------------------------------------------------------------------------------o---------------------------------------v---
-------------------------XXXX----------------------------------------XXXX--------------------------------------------T------------------------o--XXXXXXXX----------------------------------------------f---
---------------------------------------------------------------------------------------------------------------------|---------------------------------------------------------------------------------f---
----------------------------------------------------------------------------------------BBBBB------------------------|-------X?X------XXXXXXXX---T-----------------------------------------------------f---
-------------------------------------------------------XXXXX-----B---------XXXX----------------T---------------------|XXXXXXX--------------------|-----------------------------------------------------f---
-------------------------XXXXXX-----------------------------------------------X----------------|-----------XXXXXX----|---------------------------|----------------------X------------------------------f---
--------------------------------------------------oo-------------------------------------------|----------------BBBBB|BB----------XXXXXXX--------|-----------------------------------------------------f---
m------------------------------E-------------------E-------------------------------------------|---------------------|------------------------E--|-E------------------------------------------------E--X---
XXXXXXXXXXXXXXXXXXXXXXXXXXXXXXXXXXXXXXXXXXXXXXXXXXXXXXXXXXXXXXXXXXXXXXXXXXXXXXXXXXXXXXXXXXXXXXXXXXXXXXXXXXXXXXXXXXXXXXXXXXXXXXXXXXXXXXXXXXXXXXXXXXXXXXXXXXXXXXXXXXXXXXXXXXXXXXXXXXXXXXXXXXXXXXXXXXXXXXXXXXX
