-----------------------------------------------------------------------------------------------------------------------------------------------------------------------------------------------------------
------------------------------------?-----------------------------------------------o---------------------------------------------------------------------------------------------o------------------------
--------------------------------------------------------------------------------------------------------------------------o--------------------------------------------------o----------X------------------
---------------------------------o-----------------------------------------------o---------------------------------------------------------------------------------------o---------------------------------
-----------------------------------------------------------------------------------------o------------------------------------------------oo---------------------------------------------------------------
---------------------------------B------------------------------------------o--------------------------------?----o---------------o----------------------------------------------------------------o-------
----------------------------B----------o----------o-------------------------------------------------------------------------------------X------------------------------------------------------------------
--------------------------------------------------------XXXXo---------------------------X----------o-B-------------------------XXX-----------------------------------B---------------------------------v---
--------------------------------o---------------------X----------------------------------------XXXXXXXX----------------------------------------------------------------o--------B----------------------f---
--------------------------X----------------------------o--------------------------------------o---------------------------XXXX---------------------------------------------------?---------------------f---
-----------------o------------------------------------------------------------------------------------------------------------------------------------------o------------------------------------------f---
----------------------------XXXXXX-----X???------XXXX---B-----------???-?----XXXXX----------T--XXXXXX---------------------XXXXXXX--------T-------------o--B--BBBXB---o---------------------?-----------f---
-------------------X----------------------o-------------------------------------------------|--o------------------------o----------------|--------------?---------------------------------------------of---
-----------------B-----------------------------------------X--------o-----------------------|--------------------------------------------|-----------------------o-----------------------------------?-f---
m-E--------------E------------------------------------------------E----------------------E--|--------------------------------------------|-E-----------------------------------------------------------X---
XXXXXXXXXXXXXXXXXXXXXXXXXXXXXXXXXXXXXXXXXXXXXXXXXXXXXXXXXXXXXXXXXXXXXXXXXXXXXXXXXXXXXXXXXXXXXXXXXXXXXXXXXXXXXXXXXXXXXXXXXXXXXXXXXXXXXXXXXXXXXXXXXXXXXXXXXXXXXXXXXXXXXXXXXXXXXXXXXXXXXXXXXXXXXXXXXXXXXXXXXXX
