-----|X??--X-M---?---|-|-----oE-----|--EE---------M--B---M----?-----T--o---X-------------M--o--XEoE--?--X----------------M-----------EX-B-o------------oT-----E---M------T----------B--o-----XX-o-|---X-
---X-E-T?-B---X---TM--------B-|---------T------------X------M-o------o-M----|-------E-------E--M-?--E-T-------X-------T-----o---X---------E-------?X--E---T--o--B--ET---E----T-?--o---o---o--M--B-------
----------?---------|?-B-----E-T--B--M---?--M-----------T?-T-?M|----|-o---T-------o--?BE--M---BBB-------o--o--B|-----------TMMB-----To-------EB-----B--X---T---M-----?----T-T------T-?--T---------------
---X---------?------E---------T-----------||T---?-|-X---?-B-XB-B-----|-----X--B-------M--?--------E-----E---X--|-X------M|----E-----------o---?B|-----E--B-----------B-----------B-----|--M--B--B?--?o--
----|---??XB--------T---?------o-B------T-|-oE-----E-o-E-?o-?--T-----o?------T-------------------oMBM?---MM---B--------?E------E--------------E--B-----E--B-B|----M?-|--?-----M---------?--------M--oT--
------E|--E------M-----------E------T--o----T--------?--------|---------|------M-----?---E---||----M|----------?---o--------------?-?--X--?----o|----M?-EM------?-T----------EB---X----oBM----------o|--
-----M---oBE-------o---?-X---B---E-B|X------M----------o--------|-B|---E|oo?-o--o---------X-oE-------B-----E---|--------Mo-B-?----|-----|--------T---E-|----Eo---?-?-|--------o--BB--ME------E--X?------
----o---------?---?T----------MX-------?-------E-----X----|---XE|X---------E-------?-----T-E-MB|--BEMT--------|----X-----?-Bo--------E|o--o-X-E-E-----M---M-----------B-----B-----------M?---o---------v
--------X----XM--?-M----------T--X--E--T-------o-|---------------------E---------------B---E------------o---M--------E-?-o------oX?---------------B-B--T-----?-|-o------------M------o-----------------f
-------E----E--X----------E-TX|---o--E|----E--------B-B------------------------|E--X------------X----E-------X--|E--?E-T|---M-----?---T-------------E--E-?-T-B-B?---------o-E--|------E---?--------E---f
--BM-B---T--M---?-----------B------------o--M------------|-------?---XB---------M--|-------------E-----?T----------Mo----MMM-----------?MX------B-?E-o--------------------------------|B-X---E-MT----E-f
-?--ET-T--M-?T-----|-X----|------EB?-M-M---E---X-ET----oE-B------------X---?MoX----B--?|----T-TE--o---EM----?M-----o-M--?-ME-----M|-------M?-TM----X-----o-----B--X----o-----EE--E-B---------T--|B-----f
--B|-o---------oX----------?-----o-------?--|T---X-M----o-------E----|--M----|-----E-----------------------BE-----X-o--B---T-?E-oo-----------------B------------?MX----?---B-E-----o-E------------M---Ef
-?------|------?----X------|-B-|M|---------X-?--------EM-?oo------?----oBBT--B-----T----X-------?--T-X------------T-B-B--T---o-|-----BB----------------T-E--T-------|---E-EB-----?-----M|BT--X?---X--|-f
m------------------------------------------------------------------------------------------------------------------------------------------------------------------------------------------------------X
XXXXXXXXXXXXXXXXXXXXXXXXXXXXXXXXXXXXXXXXXXXXXXXXXXXXXXXXXXXXXXXXXXXXXXXXXXXXXXXXXXXXXXXXXXXXXXXXXXXXXXXXXXXXXXXXXXXXXXXXXXXXXXXXXXXXXXXXXXXXXXXXXXXXXXXXXXXXXXXXXXXXXXXXXXXXXXXXXXXXXXXXXXXXXXXXXXXXXXXX
