-----------------------------------------------------------------------------------------------------------------------------------------------------------------------------------------------------------
----------------------------------------------------------o------------------------o--------B---------------------------------------------------o--------------------------------o-------------------------
-----------------------------------------------------------------------------------------------------------------------------------------------------------------------------------------------------------
------------------------------------------------------------------------------o-----------------------------------------------------------------------------------------------o----------------------------
-----?----------------------------------------B-------------------------------------------------------------------o----------------------------------------------------------------------------------------
--------------------o-----------------------------------------------o---------------------------------X---------------------------o----------------------------?-o-----------------------------------------
-----------------------------------------------------------------------------------------------------------------------------o-------------------------B---------------------------------------------------
--------------------------------------------?------------------------------------------------------?------o---------------------------------------o-----------------X----o-----------------------------v---
------------------------------------------------XXXXXX---------T----??????---------------------------XXXXXX----------???--------XXXXXXX----------------------------------------------------------------f---
-------------------------------------------------------------o-|------------------------XXXXXXXX--------------o--------------------------------------???-----B---------------o-------------------------f---
---------------------------------------------------------------|------------------------------------o-------------------------o----------------XX------------------------------------------------------f---
-------o-------------------------------------X-----------------|------------------------------------BXBBBBB----------XXXXXXX--------o-------------------------------XXX-------------------------------Xf---
--o-o---------------XXXXXXXX-----------------------------------|---X------------------------------------------------o-------------------------------------o---------XXX--------------------------------f---
---------------------------------------------------------------|---------------------------------------------------o-XXX-----------------------------o--------------XXX--------------------------------f---
m--------------------------------------------------------------|--------------------------E-------------E-------------------------------------------------------------------------------------E----E---X---
XXXXXXXXXXXXXXXXXXXXXXXXXXXXXXXXXXXXXXXXXXXXXXXXXXXXXXXXXXXXXXXXXXXXXXXXXXXXXXXXXXXXXXXXXXXXXXXXXXXXXXXXXXXXXXXXXXXXXXXXXXXXXXXXXXXXXXXXXXXXXXXXXXXXXXXXXXXXXXXXXXXXXXXXXXXXXXXXXXXXXXXXXXXXXXXXXXXXXXXXXXX
