-----------------------------------------------------------------------------------------------------------------------------------------------------------------------------------------------------------
-------------------------------------------------------------------------------------------------------------------------------------------------------------o---------------------------------------------
----------------------------------------------------------------------------------------------------------------------------------------------------X------------------------------------------------------
-----------------------------------------------------------------------------------------------------------------------------------------------------------------o-----------------------------------------
-----------------------------------------------------------------------------------------------------------------------------------------------------------------------------------------------------------
--------------------------------------------------------------------------------------------------------o-------------------------------------------------------------------o------------------------------
------------o-------------------------------------------X-------------------------------------------------------o-------------------------------o----------------------------------------------------------
--------------------------------------------------------------------------------------------------------------------------------------------------------------o----------------------------------------v---
---------------------B----------------------------------------------------------T-------o------------XXXX---------------------------------------------------------o-----------?------------------------f---
---------------------------B-------------------------------???????--------------|--------------------------????----------------XXXXXXXX-------------------????-----------------------------------------f---
---------------------------------------------XXX--T------------------------T----|-------XX????????---------?-o---------o-------------------------------------------------------------------------------f---
------------------------------------------?-------|------------------------|----|------------------------------------------------------------------------------------XBBBBBB---------------------------f---
---------------------XXXXXXXX------------XXXX-----|------------------T-----|----|XXX-------------XXXXXXXX---XXXXXX-------------------------------------------------------------------------------------f---
------------o-------???------------------------o--|------------------|-----|----|------------------------------------------------------------------------------------------------------o---------------f---
m-------------------------------------------------|------------------|-----|----|---------------------E-----------------E--------------------E---------------------------------------------------------X---
XXXXXXXXXXXXXXXXXXXXXXXXXXXXXXXXXXXXXXXXXXXXXXXXXXXXXXXXXXXXXXXXXXXXXXXXXXXXXXXXXXXXXXXXXXXXXXXXXXXXXXXXXXXXXXXXXXXXXXXXXXXXXXXXXXXXXXXXXXXXXXXXXXXXXXXXXXXXXXXXXXXXXXXXXXXXXXXXXXXXXXXXXXXXXXXXXXXXXXXXXXX
