EoT----o|-----B-----o-B--B-|--?----|-----BXB--MBE-------M--------X---B----------X-T-Mo------oE?--------||-----o---?----T-------TTE--|----X--o------X?--oE-T------------oX-X---------o-X-------TX-T--X-oT
B?----oX-----|?------------BE----M|-----B-TE-B--M---TMT----E---|o---------E-----B-?--B--|?----?-----B-|----|---|-To-?----X-X-------X-----|----B----?-|?B---E--E---oB--E-E--M--E-T--X----------o-?------|
X--M---o---------------?E--X-o--------XB-----T--?-----M-B--E-----E-T---E-T-?-|---E----E----M-o-----|E-?X-T--X-B----------EE------------E--?---X---T-----B-----T----?------X---EE-----oT?B-T----B--o----E
----M------T?-|o-----M--E---------ME?---B---X-o-T-X--------?-?-E-------B-------------E--oT---------E----M-B-BT--------M-----EX-----------|---?-o----B------------|-o-o--E-------------M-B-M-B----E-----T
MT--|-TT---B---------|----?---E------oT-T-|-M-XBB--------o---o--EXM-------------?--B-o--B-----|-o---M-----B------oX-----T--o-----------o----------B--|------|-----T|T----------T-E-MT--------?-----T---M
o-------o-BM------EM----|---X----------E-----X---|---o---------o||--E|-----M--E-E----XB----BE-----T------E--------M---o----T--------X-------o-?-M----T-o--?--------------XEX----o--?o--------T----oM---T
--T---T-----X-------M--|--MB------T-------X-----X----oT---------o-E------MMB---------T------T?----T--------E--?---E?-M-EB-|--M-----------------T-------oE|-?-----o----B-X----------EE?-|-----oEE-----o-?
E-------------M-T|---T----------X------o--T---M--------------M-BEX-o---B-E------------|---oM-----------E---|---|?----?--|-E-E-T--X--------?o-TB-X-----------XB-E--B-X--Bo------?X--?-ET---------o---o|Ev
?----------------B?X--Mo----E--T-?--||-----?--|--X-----E-------M-o|-MoE--T----------|---E|B------M--------o-------|-M-T---B---E-----------------M?|----M---XE---M-T--|TX-T-B---Xo-----B--------------T--
?|----BM---E--TM---|-X--M----?-T---T-------|B-X--X---o---|----T-E--------|--X---BM---------oM-------X--------EEo----B-------|---B-o-T---X-T-|--o----?-----M-MT-B------|----EE|M-?-M-------X----B--?---ET
MT---||----M---T------B-?-oB---M---------?----T---T------MM-B---|--------B---o------o------T------?-----?-T--|-E---|-------M--B-------------o-o------T--M----B-|--E-ETB--E-|----------M--BBo-|----EB---B
E----------|M?---M---Xo-|-E-----M--E--|-----T--X--------T|X-o-----BMX-------o---------?XX---------------X----B---------E--------------M---o|---E----X----X?B---E--T-------M-o--BTM-----o----------B----?
X------o--o-------?-------|------o-M-o-?-M------E--BT-T--B--|---T-?M-o------o------------B--?-----?M---Bo-T--------o--------T-X-o---------------------o----------X--M-B-T-B-X-M---B--T----T|--E--B---?-B
o----o--X-M-T---T-|E-|---o-E?-------M------E----T-----?-----|----B-?-|--X-?-X------E--------T-B--?-T--------|M-?--o---|--T---?--?--oX------X---XE-o-----|---------B----XX---------TBM--------E------X--T
m----T-M|--o--B------------?---|--o----X---B--M--------------o--X-----B?---B----?---------------BB--M|-Eo--T-X--B--|------------------M---------T---o---------BX-----|-X-----E-----T-B?---|----o-------E
XXXXXXXXXXXXXXXXXXXXXXXXXXXXXXXXXXXXXXXXXXXXXXXXXXXXXXXXXXXXXXXXXXXXXXXXXXXXXXXXXXXXXXXXXXXXXXXXXXXXXXXXXXXXXXXXXXXXXXXXXXXXXXXXXXXXXXXXXXXXXXXXXXXXXXXXXXXXXXXXXXXXXXXXXXXXXXXXXXXXXXXXXXXXXXXXXXXXXXXX
