-o---T--?M---X-||-----oM---?-------M--o---o--?M-----?--X--M--?B-----B---B----------------|E?--B----Bo-XX----M----E----E---T-------|-M?--?-----M-B--------oM-----E--o---T---E--------M-o----|B----E--o-E-
----E----|---TT----o-E---|BoM-----------M---o-----------oE--------T-----------------?------To-T---?X--M--X----------BM--|----M-------M-To--X----------------o----------|-----------o?----E-|------------
------T-o-?---B-M--o--------M-----ET---------BT-----B---X---M-----E-E-----T-MB-M--X--?-------------------|----?----?-------?X-----------?-B-Eo-------T-M-----o--E--|----X---E-E-o--------M----X---------
-X--o---T-----MB---Bo-o----T?---?--------------------B---?o------TE-X------|-------------o-XM----------B-E-----o-?---?BM----------E----M-----T---|-|---ToB--o---T--o-----M---T-T--M-----?------M--B-o---
--?----------E--------M-M?-E--o-----B||--------------------|-X-|----------o---oM------|B------o-|--o--X---oT----XBM-------T------------T--X--o|--X--------------T--E-E-B--?--------------|---E----|-----
----------E-----------M--MB-E---oo-T-X-oM--T-E-----|M-----------------|---------------X-----|---XE--M----o-------Bo----------X----X------XBE--E--||-|X-E----o-B----o----TT---?--o-E--?--X?-B------------
----T---------|-|-??-------T----B-ooo--------B----o-------X---X---------o-----------T-----o---?-E--T--X--oT------BB?ME-E--XM----?-M---BXE-X----B---M---X--|---M-------T----B----?----T-B|------o-T------
-B-B--T--------T----T------X----BEo--T----X-----E-----------------o-----B----B--|?ETo-X--EM?-------oo----Bo------X-|T-----XX---o-B-------------------|-?-X---X-oE----B--?---B-T--XX|X----B---M|------?-v
-o---------X?B?|?-oM--X--?-----|X------o-X----------X------E------------o-?X-M-----E-----B---EE--M-Mo---?X----TX-------EB?X--------XX--M---|----TX---------?------X--X----M-|-|-|-----B---oMM---M-----of
---------M---T--E-----X-|B---||-E---------B-EM-TT---EE--|-------||-------o--------o---?o-B----B----------?MB-------------T-------------TTX-T--E?--M---E--M---ME---M---T---B--X---------------oB-Mo-|---f
--E?--|-----------?X----X-X|----M---------X--------X--T------EM--M-?-----BX------o--|-|---------|-o-BX-------E-M-T--?--X--BMT-M---E------B----|------M---X---o-------o-TM---M-|M-|---T----------o----B-f
-----B--M-----E-------B--|------M------M-M---|-X----o-----E--M----|-E--M----B---|--------?-TE-E|--E-------TB--M-----X--------T-----T----B---B----------------B---------------BX----|----X-------?-T----f
--T-BE-----E?-?--E----||X?-E--T------?---o---X--X-M?T-M--------M---X---X--TE-?-E-|-|--------M--E--------XE--E-----------oE------M----M--M------B-E-------------X---------------oM----BoXB-?BM--------X-f
-----oo---EoT---------M--X------------o--M----?-M-------o---X-------oo----------T--o--------------XM---------X--------T-----?-X-------E---|--?--M--E------XM----?|-----o-------o------E---E----X-T-----f
m------------------------------------------------------------------------------------------------------------------------------------------------------------------------------------------------------X
XXXXXXXXXXXXXXXXXXXXXXXXXXXXXXXXXXXXXXXXXXXXXXXXXXXXXXXXXXXXXXXXXXXXXXXXXXXXXXXXXXXXXXXXXXXXXXXXXXXXXXXXXXXXXXXXXXXXXXXXXXXXXXXXXXXXXXXXXXXXXXXXXXXXXXXXXXXXXXXXXXXXXXXXXXXXXXXXXXXXXXXXXXXXXXXXXXXXXXXX
