-B-X-B--------B------E----M---oX-B--X----?X--|---BM-T--B-X--T----M--M-BX|----BB-?----M----T--E-T-MMXo----|TE-E-|--E----M---E|-T--o---B-?--?----E--TMXTE--||X-T----Eoo---?----TMTM---X--B|-|-EX------E-B-
-E|---|-T-?-?---?--o-|--X-------------?--|-----T----E-|---o----T---|---------?o--------E--M--E-?M-T-T-----E--MM--?E-------|E--T---B--o?T---TM|-------BT-BT|o-------T---TE--T--B---M--TX-----B-T-----X-X-
-M-Xo--B----MT--o------XB----|-ETo---XM---|--o--M--------B-EX----|-B------?-X|M---|-M-?-----E---X?---X--ET--M--|-T----o---XM--M-Eo----|--B---?---------|?T-MM?---T----|---o-MT------XEET---|--XM--B-B---
-T-E------?B--X-T-MX-M|-----T-E-----?-----o-------X--|--T|E--------B-T----B---|-T-??--XE--M--M-----M---T?----M--?-T----EEE--To?XM-----X-T--E--B-M-T-|--o------?--T---oo-M|-EB-oM|--------B-TBE----M|--X-
-XT----BX----T--|-----B--------Eo---EX-?--M---X---?-o--------M?T--E---o-?|X---M|-|X--TB-oT|-M---TM----To------XB-B----ME|--------XX-----oo|---B------|--MM-B---o--T--oM----|----o-X--M-----M|M--X----?--
-B--------XM-----B-----T-X----B----Boo-o----X--X|-----|-B-o----T--XMM--MXM------BT-XMX----|X-o--oX-?B---?BT---o?-BM-B-|---M------------XTM-M-TT---?-----M----T-o----XM-|-M--|---B--B--|-?--?M-ET??------
-oBo--o--T---E--XX-MM-----?------M---MB-o---B----B---T------T-E?--T-MX|--------EM-T?-T-oT-------BB---o-|--BEX-|E-?Bo--?--|--TB-E--o-------M---T-|M-BX-----------?-T-----T---X--X-o-E-oB|EoE----X--XBMEX-
---T-|--TTM--|---E-TTo--Bo--o-o-E-?T------X-?-----?-E|-Bo-oE?M------EB-------M---T--------TT----E-----X-o-----?-o-------|------Bo----o-?ME-o--T---BBo------T?B-B-o---|----B--|-MX---|-TXE-EE--BM----TX-v
------E|MM--T--T--?---B-----------E-----o-X??|E-X-E---M----M----?-M?X--?-EB-MX--o-X-X--?---T-E-|--|-|B?----------ooo-B--o-------M-X----X?--o--TB--|-----TX-------T|BB---XT-B?-------B--|Eo-|?--EEE-----f
---E--------EB---MT---|?--XMT-T-------|-M-----M-----MXT---o||-o----?-----E---------X-TM--|-o-----|T--E-E|-B--TE-o--o-?-M-X----X-----?--------?o--T---M-T--BX---X-----o----EoE----|---E--B|----o---o---Mf
------|Xo----M-------M-------XX-B--o-----o---|-------------------T-oX--X--TXT---|EBB-T----X-----T-|--X------T-E---|--X-X--------XE--------M---TXX--o-----?oTT----B-------T-|EB------M-o--T----E--?o----f
----E-?-oE--||-----o-----??X-oX----Bo-?-|----M?TT--XEM-----?----o-M----?--X-----T------?----M-?--------M---?------E----|MM--B-o-X-M--T----------B?---?----X--|--X---T--T--o-?------------?--Eo---B-----f
---------T|M--XM-BX--T------X--o-MM-EE-----M-E?-?BEEE-B----o--?----B--??-------?-M---o-----?-o---|--T-----o--XE?------o-B------E----X-T|--X|--T-M--E--|-----o-----o-EX---o-----------|--M-----o-BM---??f
----M---E---o--M-T--E--o--oET-|---B?-?B-|-E----X------M---B--T-------B----T--oB---Eo---B|--------X?-XT----|o-M------|------?M---M?T-M--?----E?M-|T---B?M--------------E--?|---------E-E--?M-XT?EX-BX-B-f
m?-X----?-------E-------?----X---o-E|-X--X-T-----?MM---o--XX-M?-|-----oX------B-E-TE--X-?----?T----B----||--M-E-----?ETX-----B---|B---|--o-----X|B--XBM--B?B-?---T--?----M-M--T?--o--M----EBM|-B----|--X
XXXXXXXXXXXXXXXXXXXXXXXXXXXXBXXXXXXXXXXXXXXXXXXMTXXXXXXXXXXXXXXXXXTXXXoXXXXXXXXXXXXXXXXXXXXXXX-XXXXXXXXXXXXXXXXXXXXXXXXXXXXXoXXXXMXXXXXXXXXXXXXXXXXXXXXXXXXXXX-XXXXXXXXXXXXXXXXXXXXXXXXXXXXXXXXXXXX-XX-X
