-----------------------------------------------------------------------------------------------------------------------------------------------------------------------------------------------------------
--------------------------------------------------------------------------------------------------------------------------------o--------------------------------------------------------------------------
--------------------------------------------------------------------------------?--------------------------------------------------------------------------------------------------------------------------
---------------------o-------------------------------------------------------------------------------------------------------------------------------------------------------------------------------------
------------o-----------------------X-------------o----------------------------------------oo---o----------------------------------------------------------------------------------------------------------
--------------------------------------------------------X------------------------------------------------?-----------------------------------o-----------------?-------------------------------------------
-------------------------------X----------------------------------------------------B-------------------------------------------------------------------------------------X---o----------------------------
-----------------------------------------------------------------------------------------------------------------------------------------------o------------------o-------------------------------o----v---
--------------------XXXX------X------------XXX-------XXXXX----------------o---------------------------------XXXX------------------------------------------X------------------X-------------------------f---
----o------------------------------X--------------XXXXXXXX--?????-------XXB-X---BBBBB?BB--------------------------------????XXXXXXX------------o-----------------XXX-----------------o-----------------f---
-----------------------------------------------------XXX---------------------------------------o--------------------XXX-------------------------------XXX----------------------------------------------f---
----------------------------------------------------------------------------------oo-----------o------------------------------------------------------o-----------------------------------------?------f---
-------------------BBBBBBBT-------------------------------XXXXXBXX-----------XXX----------------------XX------------------T---------------------------T------------------------------------------------f---
--------------------------|XXXX----------?????-----o--B-----------------------oo----------------------B-------------------|-----------XXXXX-XXXXXXX---|------------XXXXXX---------------o--------------f---
m------------EE-----------|--------------------------------------------E--------E----------------------------E------------|------------------E--------|--------------------E-----------E--------------oX---
XXXXXXXXXXXXXXXXXXXXXXXXXXXXXXXXXXXXXXXXXXXXXXXXXXXXXXXXXXXXXXXXXXXXXXXXXXXXXXXXXXXXXXXXXXXXXXXXXXXXXXXXXXXXXXXXXXXXXXXXXXXXXXXXXXXXXXXXXXXXXXXXXXXXXXXXXXXXXXXXXXXXXXXXXXXXXXXXXXXXXXXXXXXXXXXXXXXXXXXXXXX
