-----------------------------------------------------------------------------------------------------------------------------------------------------------------------------------------------------------
----------------------------------------------------X-----------------B-------------------------------------------------------o---------------------------------------------------o------------------------
------------------------------------------------------------o-----------------------B-------------------------------------------------------o--------------------------------------------------------------
-----------?---------------------o------------------------------------------------------------------------------------------X---------------------------o--------------------------------------o-----------
--------B--------------------------------------------------------------------------------------X--------------------------------------------------------------------X--------------------------------------
--------------B--------------X-------o---------------------------------X-------------X-------------------------------------------X---o---------------B-----------------------------------------------------
---------------o----------------------------------------------------?---o--------------------------o-----------------?------------------o-------------------------o-------?--------------------------------
------------------------o----------------o--X-------------------------------------------------o---o-----------------------o--o------------------------X------------------------------------------------v---
------o--------------X--------o--XX------------------------------oXBXX--o------------------X--------------------------------?------------------------------XXXXXXX--o----B-----------------------------f---
---------------------------------------------------------BBBB----------------------------------------XXXXXX??X???X------------X--------------BBB---BBB----XXXBXBXo--------------------o-?--------------f---
----------------------------------------------X--------------------------------------o---------o---------------------------------------------X-------------B------------------------B------------------f---
------------------o-----o-XXX--------------------X-------------------------------------------BBBBBBBB--XXXX-------XX?--X---------X----X?XBXX--------------------------X---------------?-------------o--f---
-------------------------------------o--------------------------X?XXXXXXXXo--------------------------------------------------o-----o-------------------------------------------------------------?-----f---
-----------------------------------------------o--XXXXXXX---oo--------------------------------------X------o-----------------------o--?-----------------------------------------------------?----------f---
m-----------------------------------------------------------E---------------------E--------------------------------------------------E---E-------------------------------------------------------------X---
XXXXXXXXXXXXXXXXXXXXXXXXXXXXXXXXXXXXXXXXXXXXXXXXXXXXXXXXXXXXXXXXXXXXXXXXXXXXXXXXXXXXXXXXXXXXXXXXXXXXXXXXXXXXXXXXXXXXXXXXXXXXXXXXXXXXXXXXXXXXXXXXXXXXXXXXXXXXXXXXXXXXXXXXXXXXXXXXXXXXXXXXXXXXXXXXXXXXXXXXXXX
