-----------------------------------------------------------------------------------------------------------------------------------------------------------------------------------------------------------
-----------------------------------------------------------------------------------------------------------------------------------------------------------------------------------------------------------
-----------------------------------------------------------------------------------------------------------------------------------------------------------------------------------------------------------
-----------------------------------------------------------------------------------------------------------------------------------------------------------------------------------------------------------
------------------------------------XXXX-------------------------------------------------------------------------------------------------------------------------------------------------------------------
-----------------------------------------------------------------------------------------------------------------------------------------------------------------------------------------------------------
-----------------------------------------------------------------------------------------------------------------------------------------------------------------------------------------------------------
------------------------------------XXX------------------------------------------------------------------------------XXXX------------------------------------------o-----------------------------------v---
------------------------------------------------------------------------------------------------------------------------------------------------------------XXXXXXXX-----------------------------------f---
-------------------------------------------------------------------------------------------------------------------------------XXXXXX------------------------------------------------------------------f---
-------------------------------------------------------------------------------------------------------------------------------------------------------------------------------------------------------f---
--------------------------XXXX---XXXX---------------------------------------------------------------------XXXXXXXX-XXXXXXXX----XXXXXXX-XXXXX-------------T-BBB-----------------------------------------f---
--------------------------------------------------------------------------------------------------------------------------------------------------------o|---------------------------------------------f---
---------------------------------------------------------------------------------------------------------------------------------------------------------|---------------------------------------------f---
m------------------------------------------------------------------------------------------E----------------------o-----E----------------------E---------|---------------------------------------------X---
XXXXXXXXXXXXXXXXXXXXXXXXXXXXXXXXXXXXXXXXXXXXXXXXXXXXXXXXXXXXXXXXXXXXXXXXXXXXXXXXXXXXXXXXXXXXXXXXXXXXXXXXXXXXXXXXXXXXXXXXXXXXXXXXXXXXXXXXXXXXXXXXXXXXXXXXXXXXXXXXXXXXXXXXXXXXXXXXXXXXXXXXXXXXXXXXXXXXXXXXXXX
