-----------------------------------------------------------------------------------------------------------------------------------------------------------------------------------------------------------
-------------o------------------o---------------------------------------------------------------------------------------------------------o----------------------------------------------------------------
-----------------------------------------------------------------X----------------o------------------------------------------------------------------------------X-------o---------------------------------
-----------------------------------------------------------------------------------------------------------------------------------------------------------------------------------------------------------
-------------------------------------------------------------------------------------------------------------------------------------------------------X--------------------o------------------------------
-----------------------------------------------------------------------------------------------------------------------------------------------------------------------------------------------------------
--------------------------o----o--------------------------------B-----------------------------------------------X------------------------------------------------------------------------------------------
-------------?---------------------?-----------------------------------X----------------------------------o--------------------------------------------X-----------------------------------------------v---
-----------------------------------------------------------------o----------------------------------------------XXXX?X---------------------------------------------------------------------------------f---
---------------o-o-------------------------------------?--------XXXX----------------------------------------------------------------------------------------------------------------------------o------f---
---------------------------------------------------------------------------B---------------------------------------------------------------------------------------------------------------------------f---
------------------------T---------------X---T----------------------------X--------------------T-------------------------o--------o---------------XXX-----------------------------?---------------------f---
------------------------|-------------------|----XXX-XX---------------------------------------|------------------------XXXXXXX---------------T---------------------------------------------------------f---
----------------o-------|-------------------|-------------------------------------------------|-----------------------------------o-----XXXXX|---------------------------------------------------------f---
m-------EE--------------|-------E-----------|-------------------------------------------------|----------E-----EE----------------------------|---------------------------------------------------------X---
XXXXXXXXXXXXXXXXXXXXXXXXXXXXXXXXXXXXXXXXXXXXXXXXXXXXXXXXXXXXXXXXXXXXXXXXXXXXXXXXXXXXXXXXXXXXXXXXXXXXXXXXXXXXXXXXXXXXXXXXXXXXXXXXXXXXXXXXXXXXXXXXXXXXXXXXXXXXXXXXXXXXXXXXXXXXXXXXXXXXXXXXXXXXXXXXXXXXXXXXXXX
