-----------------------------------------------------------------------------------------------------------------------------------------------------------------------------------------------------------
--o---------------------------------------------------------------------------------------------------------------------------------------o-----------------------------------------------------o----------
-----------o------------------o-----------------------------------------------------------------------------------------------------------------------------o----------------------------------------------
---------------------------------------------------------o--------------------------------------------------------------------------o-------------------------------------------B--------------------------
--------------------------------------------------o-----------------------------------------------------------------------------------B------------------------------------------------o-------------------
-----------------------------------------X--------------X--------------------------------------------------------------------------------------------------------------------------------------------------
----------------------------------------------------------------------------?--------------X----------------------o----------------------------------------X-----------------------------------------------
-------------------------------------------o-----------------------------------------------------------------------------------------------------------------------------------------------------------v---
----------------------------------------o--------------------XXXXXXXX------------------------------------X--------------o---X-------------------------o------------------------------------------------f---
---------?---------------o----------XXBXX?XX-----------------------???-----------------------------------------------------?????---------------------?-?-----------------------------------------------f---
------------------------------------XXX----------------------------------XXXXXX--------------------------------------------------o--------XXXXXXX-----------XX-----------------------------------------f---
-----------------------o--------------------------------------------XBXXXX--------------------------T------------XXXX---------------------------------o-------------------------X----------------------f---
-----------------------------------------------------------?XXXXXX------------X---------------------|-------------------------------------o------------------------------------?-----------------------f---
--------------------------------XXXX----------------X-XXXXXXX---------------------------------------|---?----------------------------------------------------------------------------------------------f---
m-E-----------E--------------------------------o----------------------------------------------------|------------------------E-------------------------------------------E-----------------------------X---
XXXXXXXXXXXXXXXXXXXXXXXXXXXXXXXXXXXXXXXXXXXXXXXXXXXXXXXXXXXXXXXXXXXXXXXXXXXXXXXXXXXXXXXXXXXXXXXXXXXXXXXXXXXXXXXXXXXXXXXXXXXXXXXXXXXXXXXXXXXXXXXXXXXXXXXXXXXXXXXXXXXXXXXXXXXXXXXXXXXXXXXXXXXXXXXXXXXXXXXXXXX
