-----------------------------------------------------------------------------------------------------------------------------------------------------------------------------------------------------------
-----------------------------------------------------------------------o-----------------o-----------------------------------------------------------------------------------------------------------------
--------------------------------------o--------------------------------------------------------------------------------------------------------------------------------------------------------------------
---------------------------------------------------------------------------------------------------------------------------------------------------------------------o-------------------------------------
------------------o----------------------------------------------------------------------------------------------------------------------------------------------------------------------------------------
-------------------------------------------o-------------------------------------------------------------------------------------------o-------------------------------------------------------------------
-------------------------------------------------------------------------------------------o-------------------------------------------------------------X----------------------------------o--------------
-------------------------------------------------------------------------------------------------------------------------------------------------------------------------------------------------------v---
----------------------X----------------------------XXXXXXXX--------------T----------------????X-------------T------???-------oXXXTXXXX-----------------------------------------------------------------f---
-------------------------------T-----------------------------------------|----------------------------------|--------------------|---------------------------------------------------------------------f---
-------------------------------|------------XXXXX------------------------|-------------------------XXX-----X|XXX-----------------|----------------------------------------X----------------------------f---
----------------------------T--|----------------------------------------X|XXXX---BBB--T---------------------|--------------------|-T------------------------------------o--------X---------------------f---
------------------X---------|--|-------------B---------------T-----------|------------|--------XXXXXXX------|--------------------|-|---BBBBBB???----------------------------------------------o--------f---
--------------------o-------|--|------------o---XXXXXXXX-----|-----------|------------|--------?XXXBXXX-----|-------XXXXXXX------|-|--------------------XXXX-------------------------------------------f---
m-E-------------------------|--|-------E---------------------|-----------|------------|---------------------|E-------------------|-|-----------------E-------------------------------------------------X---
XXXXXXXXXXXXXXXXXXXXXXXXXXXXXXXXXXXXXXXXXXXXXXXXXXXXXXXXXXXXXXXXXXXXXXXXXXXXXXXXXXXXXXXXXXXXXXXXXXXXXXXXXXXXXXXXXXXXXXXXXXXXXXXXXXXXXXXXXXXXXXXXXXXXXXXXXXXXXXXXXXXXXXXXXXXXXXXXXXXXXXXXXXXXXXXXXXXXXXXXXXX
