-----------------------------------------------------------------------------------------------------------------------------------------------------------------------------------------------------------
--------------------------------------------------------------------------------B------------------------------------------------------------------------------o-------------------------------------------
-----------------------------------------------o---------------------------------------------------------------------------------------XXBXB--------------------------------------------------------?------
----------------------------------------------------o------------------------------X-------------------------------------------X-------------------------------------o--o----------------------------------
-------------------------------------o-----------------------------------------o-----------------------------------o------------------o-------------------------------------------o------------------------
---------------------------------------------------------------XBB-------------------------BBBBBBBB---------X---------o------B-----------------------------------BBBXBBB-----------------------------------
-------------------------------------------------------BBBBBBB-----------------------o----------------------o----o-----------------oXBBBBBBB------------------------?--------------------------------------
------------------o--------------XBB-------------BBBBB--------????-----------------------o-BBB------------------X---BBBBB-------------------o----------------------------------------------------------v---
----------------------B-------------------------T------BXBB--o--------------------o-----------------------------------------------------------------------------------X--------------------------------f---
------------------------------------------------|-----------------------------BXBBXBB---BBB-BBT-------------------------------------X?????--------------------BXB-BB-----------------------------------f---
------------------------------------------------|-------------------------T--------------T----|----------o-------------------------------------o-------------------------------------------------------f---
----------BBB------------T-------XX-X---------BB|B---BBBB---BBB----T---XXX|BBBBBB-------B|BBBB|B-----------X-----BBBBBBBB----?X????X?----------------------???????X------------------------o-----------f---
-------------------------|----------------------|o-----------------|--o---|--------------|----|----------------------------------------------------------------------------o---?-----------------------f---
-------------------------|----------o-----------|----------o-------|------|--------------|----|--------------------------------------------------------------------------------------------X-----------f---
m------------------------|-------E--------------|----EE------------|------|-E------------|----|------------------------------------------o----------------------------E--------------------------------X---
XXXXXXXXXXXXXXXXXXXXXXXXXXXXXXXXXXXXXXXXXXXXXXXXXXXXXXXXXXXXXXXXXXXXXXXXXXXXXXXXXXXXXXXXXXXXXXXXXXXXXXXXXXXXXXXXXXXXXXXXXXXXXXXXXXXXXXXXXXXXXXXXXXXXXXXXXXXXXXXXXXXXXXXXXXXXXXXXXXXXXXXXXXXXXXXXXXXXXXXXXXX
