-----------------------------------------------------------------------------------------------------------------------------------------------------------------------------------------------------------
----------X--?----------------------------------------------------------------o---------------------------o---o---o---------------X--------------------------o-----------------o---------------------------
------o--------------------o---------o------------------------------------?--------------------------------o----------------o---------------------B------------------------------------------B-------------
--------------------o---------B-?------------------------B--BX---o------------BB----------------------X-XX--------------------------------o--o-------------------------oo----X-------------------o---------
----B--------------------o----------X----B----o------X----------------------o------------B----------------o----------------------------------------------------------------------------------o-----X-o-----
------X----------B--------X-------------------------BBX-B-------------XXB--------------B-B------B-B----B-----------X---X--XX?-------o-X--?XXX----------X---------X----oX-------------?-------X-------------
----------------o-------o--------o---------------o----o--------o------------o---------------------------o--o----------------------o--------oE---------o-----------BB-BBX------------o---X-------o----------
-X----------------------------XXBBBB--------------------------------BBB---o-----------------X-XX---o-------B----------o--B-B--------BBBB-B-BB-B-X----------------------o-------------------------------v---
-B--o----------------------XB-----------------------XXX-------------------o-T--o-X----------------XXX----------------o-----------o--o--------------------------XX-X--------------?---------------------f---
-------------o------o--------B-------------------------------------B-B------|------------------------------------B---BBBB----B---------X-XX-----BBB--BB------T------o-----o----------------?-----------f---
--o--------o---------------------o-----------------------------------T------|----o-------------o---------?-------o-----T----oo-------o-------------------X---|-----------------------------------------f---
---o---------------BB-----BBBBB---------------B----BX---------BB-B-B-|---BBB|B-B------------B--BB?--XBB-BX-BBB--XXX---B|----BX---BB-X-XX--------?X?-----B-BBB|o----------------------------------------f---
---------------------------------------o-------o---------------------|------|-----------------------------------T------|o-----B-T-------------------------o--|T-------o--o------------o----------------f---
--------------------o-------------------o----------------------------|o-----|-----------------------------------|----o-|--------|-----------------o----------||-------o-------------oo------X--X-------f---
m-E----E-----------------------------------E-------------------------|------|-----------E-----------E-----------|------|--------|----E-----------------------||---E------------------------------------X---
XXXXXXXXXXXXXXXXXXXXXXXXXXXXXXXXXXXXXXXXXXXXXXXXXXXXXXXXXXXXXXXXXXXXXXXXXXXXXXXXXXXXXXXXXXXXXXXXXXXXXXXXXXXXXXXXXXXXXXXXXXXXXXXXXXXXXXXXXXXXXXXXXXXXXXXXXXXXXXXXXXXXXXXXXXXXXXXXXXXXXXXXXXXXXXXXXXXXXXXXXXX
