--------------------------------------------------------------------------------------------------------------------------------------------------------------------------------------------------------------
-----------------------------------------------------------------------o--------------------------------------------------------------------------------------------------------------------------------------
-----?-----------------------o------------------------------------------------------------------------------------------o-------------------?-----------------------------------------------------------------
-----------------oo-------------------------------------X--------------------------o--------------?-----------o--------------------------------------------------B--------------------------------------------
---------------------------------------------------------------------o---------------o--------BB--------------------o-------------o--------------X----------------------------o-------------------------------
-------------?---------X--X-----------------------o----------------------X--------------------------------?-----------------------------------------------?------------X--------o-----------------------------
----------o-------X-----------------------?--------------------BB-----------------------------o----------o-X---------------------X-----------B-----------------o----------------------------------------------
-----------------------------------o-------------------------o---------------------------------------------------o--o--BBBBBBBB-------o--?----------------------------------------------o--------------v------
------------------------------------------------X------o---------------XBBB-----------------BBB--------BB--B---o-----------------------TT------X----------------?--------------------------------------f------
---X--------------X--oX-------------o-------------------oo------------------------------------------T-o---------------------T---------B||---T----------------------------------------------------------f------
-----------o-----------------------------o-----------------------------------T---------------T------|-----------------------|-------E--||---|-----------------o----------------------X-----------------f------
-----------------------XBX--------B------------BBBBB-?????-----------????----|-----BBB----BBB|---B-B|B-B--------------BXoBBB|-B----BBBB||-BB|B-----------------T---------o-----------------------------f------
-----------------------------------------------------------------------------|---------------|-T----|------o----------------|--T-------||--T|-------T--T-------|-----------------o---------------------f------
-------------------------------------------------?---------------------------|---------------|-|----|---------X---------X---|--|-------||--||-------|--|-------|---o-----------?----------------------of------
m---------------------------------------------------------------E-----------E|---------------|-|----|-----------------E-----|--|-------||-E||-------|--|-------|----------------------------E----------X------
XXXXXXXXXXXXXXXXXXXXXXXXXXXXXXXXXXXXXXXXXXXXXXXXXXXXXXXXXXXXXXXXXXXXXXXXXXXXXXXXXXXXXXXXXXXXXXXXXXXXXXXXXXXXXXXXXXXXXXXXXXXXXXXXXXXXXXXXXXXXXXXXXXXXXXXXXXXXXXXXXXXXXXXXXXXXXXXXXXXXXXXXXXXXXXXXXXXXXXXXXXXXXX
