-----------------------------------------------------------------------------------------------------------------------------------------------------------------------------------------------------------
-------------------------X-----------------------------------------------------------------------------------------------------------------------X------------------------------------------B--------------
--------------------o-------------------------------------------------------------------------------------------------------------------------------------------------o------------------------------------
----------------------------------------------------------------------------------------------------o-----------------------o------------------------------------------------------------------------------
-----------------------------------------------------------------------------------------------------------------------------------------------------------------------------------------------------------
----------------------------------------------------?------------------------------------------------------------------------------------------------------------------------------------------------------
-----------------------------------------------------------------------------------------------------------------------------------------------------------------------------------------------------------
--------------------------------------------------o----------------------------------------------------------------------------------------------------------------------------------------------------v---
----------------------------------------------------------------XXXXXXXX-----------------------------------------------------------------------XXX---------------------------------------------------o-f---
-------------------------T---------------------------o--XXX--XXXXXXXX-------------------------------------------------------------------------------------XXXXXXX--------------------------------------f---
-------------------------|--------------------------------------------------o--------------------------------------------------------------------------------------------------------------------------f---
--------------------XXX--|---------------------------------------------------XXXXX------X----XXXXXX----------------------?????--------------------XXX---------T----------------------------------------f---
-------------------------|----------------------------------------??????--XXXX-----------BBBBBBBB---------------------------------------------oo--------------|----------------------------------------f---
-------------------------|-------------------------------------------------XXXXXX------------------------------o-o---------------------------------------o----|----------------------------------------f---
m-EE---------------------|-------E--------------------------------------------------------------------------E-------------------------------------------------|-E--------E-------------E---------------X---
XXXXXXXXXXXXXXXXXXXXXXXXXXXXXXXXXXXXXXXXXXXXXXXXXXXXXXXXXXXXXXXXXXXXXXXXXXXXXXXXXXXXXXXXXXXXXXXXXXXXXXXXXXXXXXXXXXXXXXXXXXXXXXXXXXXXXXXXXXXXXXXXXXXXXXXXXXXXXXXXXXXXXXXXXXXXXXXXXXXXXXXXXXXXXXXXXXXXXXXXXXX
