--------o--------B--------------BTM---B--X?----|--o|----X--E---o?-BE?-||---X---B-B-----------M---------X?Mo-X-------E----XM--X-|-------T-------X-------------?-o---|-M---B----o---------------T-XE------
-------TBM-E-------|B---|------X------E|----T--B------M-ooB---?-T--E-------B--B-|--|-o---?------M----------------------Bo--B-o|----Eo-oEo--E------M-?----X-----?--M---X----B-o---------------|E----?--B-
--B--|-X-o---?------|---X---o-|?----E---------------oo-------------X---|--------B-|X--X----E--E--------?--M--|-EE-----M---M-----T----o----M----------?-E-B-X--M-T---E----o-|-?|-X--|B---------------?-|-
-----------?EE-?--|------|-------X------oT--------BM----------B--E--o-----E--o?----|-X------o---T|-M-----oT--------X-B----M---o----M-o-----------BoB--B---B-------?------TE--------B----o----T---M----M-
--M-------?-------T-M-X---E--oX--ET---o--o---EM----T?----|---|E-E---?----M-|E--------B--oX----T--?----o-XM-----E|------o------?-M----TEo------------o-?--E------?--------?|--------|o-----E--o---MX-----
-----B--X---T-------EE--?-X----X--B-------------------o----X---------B-B---B----?B-|--M-|----?T-?-T-------|o--X----B--?o--------oM---|T-|--B-oE-ET---------E------o------------|-----E--?X-----BB--B-M--
----------o---------X|M---------E-?-|-----E?---------|------------------X-----------XE-------o---------?-------||----E---X-------T-----o---?--T---B-----o?---E------|o---BM--|?----M-----X--------------
----Xo--T--B-?--T--?-----?T--|------------X-E------BE----oo|---T-B---X---B------T----E-B---|-----|------M-T----|----------E--T---?M-----|-----------oM------?|M------E--?---------M---XE--E--T-X-------v
-M-?-Xo--X------M------E----B---T--------?----B-T--T-|--------X----T---------?-E-|----------Eo---E-B---------MM-------B-?--T----E--------X-MT-T---XoT----B-E----oE----X-------|---TM?--------?--|----X-f
-|B-X-X------?---?--------------T-E------ME--------M--E---o-M-o--?----M---TM-T---|-o------o------X----X-?------X---?---------?|E--o---------X--------------|--|------MMB---M----B---------B---?M------?f
-?--|E------------------?-M---o---T---------?----o---------E-BM-|-?-T--X-------------------o-----X----|-?--B------------o---?---TX------|-----|---?-----------?--BM------M--?-----X|-BT---------T----T-f
-----|------X?-------B--------E----T-XE?--?X-------T------E------E-o-|M---------T----|-----EM---------------o---------B--E--------oM----M---M-o-----?----X----------o----E---TB---E-M-X---EE-X----T----f
---------------o--E----M---oT--?T--?X----T---B-------ToB---X|-E-------M--M-----oX--|-|o-o---o---------MX-oT-T--o-X-B--X--E--------------?-XX---------M---M----?----E--BM---X----|T--?-----M-?--oMT-----f
--X--o-----?-T-M------o-X|------ME--------MT-XT-E----------X----o-ET----?-o--E-----?----E--M-T-----------------o----|M-E---X----------X---?---o----------E-X|----------|---M-?|o---M-------------------f
m-----?-TM-------------T?T-|-----o-------E-----o---------|M----M---T---------o--------X---B--X----?---T-|----?B----------T--T----?M-T----E--------B--E?-----------o||-----------B??------X----MB-------X
XXXXXXXXXXXXXXXXXXXXXXXXXXXXXXXXXXXXXXXXXXXXXXXXXXXXXXXXXXXXXXXXXXXXXXXXXXXXXXXXXXXXXXXXXXXXXXXXXXXXXXXXXXXXXXXXXXXXXXXXXXXXXXXXXXXXXXXXXXXXXXXXXXXXXXXXXXXXXXXXXXXXXXXXXXXXXXXXXXXXXXXXXXXXXXXXXXXXXXXX
