--------------------------------------------------------------------------------------------------------------------------------------------------------------------------------------------------------
--------------------------------------------------------------------------------------------------------------------------------------------------------------------------?-----o-----------------------
--------------------------------------------------------------------------------------------------------------------------------------------------------------------------------------------------------
------------------------------------------------------------------------------------------------?-------------------------------------------------------------------------------------------------------
---------------------------------------------------------o----------------------------------------------------------------------------------------------------------------------------------------------
--------------------------------------------------------------------------------------------------------------------------------------------------------------------------------------------------------
-------------------------B---------o------------X---------------------------------------------------------------------------------------B------------------------------------------------------X--------
-------------------------------------------------------------------------------------o-----------------------------------------------------------------------------------------------------------------v
------------------------------------------------XXXXXXXX-------------------------BBBB------------------------------------------------------------------------------------------------------------------f
--------------------------------------------------------------------o-----------XXXX-----------------------------------X-XX?X--------------------------------------------------------------------------f
-----------------------------------------------------XXXXXXX--------------------------------------------------------------------------------XXXX-------------XXXXX-------------------------------------f
-----------------------------------------------------------o-------------------XXXX------???????---------------T-------------------?????-----------------------------E---------------------------------f
-----------------------------X--------------------BXXX---------XXXTXXXXXXXXXXXT--------------------------------|--XXXXXX----------------XXXXXX----------------------XXXXXXXX---------------------------f
----------------------------XXXXX---------------------------------|----------o|--------------------------------|---------------------XXXX--------------------------------------------------------------f
m-E---------------------------------------------------------E-----|-----------|-----------------E--------------|----------------------------------E----------------------------------------------------X
XXXXXXXXXXXXXXXXXXXXXXXXXXXXXXXXXXXXXXXXXXXXXXXXXXXXXXXXXXXXXXXXXXXXXXXXXXXXXXXXXXXXXXXXXXXXXXXXXXXXXXXXXXXXXXXXXXXXXXXXXXXXXXXXXXXXXXXXXXXXXXXXXXXXXXXXXXXXXXXXXXXXXXXXXXXXXXXXXXXXXXXXXXXXXXXXXXXXXXXX
