-----------------------------------------------------------------------------------------------------------------------------------------------------------------------------------------------------------
-------------------------------------------------------------------------------------------B---------------------X--------------o--------------------------------------------------------------X-----------
---------------------------------------------------------------------------o-------------------------------------------------------------------------------------------------------------------------------
--------------------------------------------------------------------------------------------------o-----------------------------------------------------------------------------------------o--------------
-----------------------------------------------------------------------------------------------------------------------------------------------------------------------------------------------------------
----------------------------------------------------------------------------------------------X------------X-----------------o-----------------------------------------------------------------------------
--o--------------------------------------------------------------------------------------------------------------------------------------------------------------------------------------------------------
-o------------------------------------------------XXX----------------------BXBBBBBB------------------XXXXXXXX------------------------------------------------------------------------------------------v---
--------------------------------------o----------------------------------------------------------------------------------------------------T--------o--------------------------------------------------f---
-------------------------X-------------------------------------------o---------------------------------------------------------------------|-------------T---------------------------------------------f---
----------------------------?----------T---------------------------------------------------------------------------------------------------|-------------|---------------------------------------------f---
---------------------X---------XXX-----|---------XXXXXXX----------BBBBBBXXXXXXXX-----???????--XXTXXXX?--XXXXX--XXXXXX-X----------X--------X|XX?XXXXXXXXXX|--------XXXXX--o-----------------------------f---
---------------------------------------|--------------------------------------------------------|----------X-------------------------------|-------------|---------------------------------------------f---
---------------------------------------|----------------------------X---------------------------|------------------------------------------|-------------|---------------------------------------------f---
m-----E--------------------------E-----|--------------------------------------------------------|----------------------------------------E-|-------------|---------------------------------------------X---
XXXXXXXXXXXXXXXXXXXXXXXXXXXXXXXXXXXXXXXXXXXXXXXXXXXXXXXXXXXXXXXXXXXXXXXXXXXXXXXXXXXXXXXXXXXXXXXXXXXXXXXXXXXXXXXXXXXXXXXXXXXXXXXXXXXXXXXXXXXXXXXXXXXXXXXXXXXXXXXXXXXXXXXXXXXXXXXXXXXXXXXXXXXXXXXXXXXXXXXXXXX
