--------------------------------------------------------------------------------------------------------------------------------------------------------------------------------------------------------------
--------------------------------------------o-----------------------------------------------------------------------------------X-----------------------o----------------B---------------o--------------------
-------------------------------o----------------------------------X----------o-------------------------------o-------B----------------------------o---------------------------------X-------------------------
-------------------o------------------------------------------o----o---------------------------------?----------------------------------------------X--------------------------------o----------o-------------
---------------------------------o----------------------------------------------------------------------------------------------------------------------------------------------------------------------------
--------------------------------------?------------------XBB-BB-------------------------o----------------------BBBB-------------------------o----------------------------------------X------------------------
------------------------------------------------------------------------X-------------------------------o------------------------------------B-o------------------------------X-------------------------------
--------------------B-----------??-??-------------------BBB-B---------???------------BBBBBBB------------------------------------BBBBBX-----?-----BBB--------------------X-----------------------B------v------
---o-------------------X-o-------o-----T-o----------T----------------------o-----------------o-T--------------BBBB?-----T-------------------o---o------------------------------------------------------f------
---------------------------------------|------------|---------o-----------------------T--------|-------o---BBB----------|-----------------------------------------o--o---------------------------------f------
-----------------o---------------------|------------|-----------------------T-------o-|--------|------------------------|------------------------------------------------------------------------------f------
-------------------------------BBBoBB-B|BBBBBB--BBBB|BB--------TT??BBB?B-BB-|-----B-XB|B----B?X|B-X?X??--???????---B?BBB|BB-BXXBB?B---BBB------BB?BBBBB--o----?-????-----------------------------------f------
------------------------------o--o-o---|------------|----------||-----------|---------|-T------|---------?--------------|---------------------------------o--------------------------------------------f------
---------------------------------------|------------|----------||-----------|-------X-|-|------|------------B-----------|--------X-------------------o-----o-----------------------------------------o-f------
m-------E------------------------------|------------|----------||----E----E-|---------|-|------|------------------------|--------------E-------------E--------------------------------E------------E---X------
XXXXXXXXXXXXXXXXXXXXXXXXXXXXXXXXXXXXXXXXXXXXXXXXXXXXXXXXXXXXXXXXXXXXXXXXXXXXXXXXXXXXXXXXXXXXXXXXXXXXXXXXXXXXXXXXXXXXXXXXXXXXXXXXXXXXXXXXXXXXXXXXXXXXXXXXXXXXXXXXXXXXXXXXXXXXXXXXXXXXXXXXXXXXXXXXXXXXXXXXXXXXXX
