-----------------------------------------------------------------------------------------------------------------------------------------------------------------------------------------------------------
--------------------------------------------o--------o----------------------------------------------------------------o--o------------------------X--------------------------------------------------------
--------------------------------------------------------------------------------------------------------X--------------------------------------------------------------------------------------------------
--------------------------------------------------X--BBB-----------------------------------------------------BBBBBBBB----------------------------------------------------------o----------o----------------
---------------------------------------o---------------?------------------o--------------------------------------------------------------------------------------o------------------o----------------------
----o------------------------------------------------------------------------o----------------------------------------------------------o---------------------B---------X----------------------------------
---------------------------------------------------------X-------------------------------------------------o--------------------------------------o--X-----------------------------------------------------
-----------------X-----------------------------------???-----------??????----?---------------------BB------BBX------------------------------------------------------------------o----------------------v---
--------------------B--------------X----------------------------------------------------BBB-----------------------------------------------X----------------o--------BBB--------------X-----------------f---
-------o------------T--------------------------------------------------------------B?BXB------------------B-BBB-------------------o--------------------------------------------------------------------f---
---X----------------|---------------T--T-----------------------------------------------------------------------------------T----T-------------------------o--------------------------------------------f---
-------------------B|BBBB-XXXXX-----|--|--BBBBBBBB?BXBBXB-------XXXXX-----------??-?--BBBB-------BBBB--TBBBBB-T--BBBBBBB---|BB--|---BXTBBBBBBB---BBBB---------T---------?------------------------------f---
--------------------|--------------T|--|------------------------------o---------------------o----------|------|------------|----|-----|---------T-------------|----------------------------------------f---
--------------------|--------------||--|---------------------------------------------------------------|------|------------|----|-----|---------|-------------|------------------------------?---------f---
m-E-----------------|-E-------E----||--|---------------------------------------------------------------|------|------------|----|-----|---------|-------------|-E-----------------E--------------------X---
XXXXXXXXXXXXXXXXXXXXXXXXXXXXXXXXXXXXXXXXXXXXXXXXXXXXXXXXXXXXXXXXXXXXXXXXXXXXXXXXXXXXXXXXXXXXXXXXXXXXXXXXXXXXXXXXXXXXXXXXXXXXXXXXXXXXXXXXXXXXXXXXXXXXXXXXXXXXXXXXXXXXXXXXXXXXXXXXXXXXXXXXXXXXXXXXXXXXXXXXXXX
