-----------------------------------------------------------------------------------------------------------------------------------------------------------------------------------------------------------
----------------------------------------------------------------------------o------------X-----------------------------------------------------------------------------------------------------------------
----------------------------------------------o-----------------------------------o------------------o------------------------o-------------------o--o-----------------------------------------------------
------------------o-----o-o-------------------------------------------------------------------------------------------o------------------------------------------------------------------------------------
-------------------------X-------------?--------------o---------o--------------------------------------?-------------X------------o-------------------------------------------------------B----------------
---------------------------B---------------------------------------------------o--------B-----------------------------o-BBBBXBBB-------------------------?----B---------o----------------------------------
--------------------------------------------------X------------------------------------------------------------------------------------------------o----------------------B--------o------o----------------
----------------o-----o----------X----------------------------------------------------XX-----------------BBBB--------o-------------------X-------------------------------------------------------------v---
---------X------------T-------------------o-------------------o----XBB-----------------------------------------o--------------------------BBBX---------------X-----------------------------------------f---
----------------------|------X------------B-BBBB---o------------o----------o---------------------------o--o-------------XXXXX-------------------------------------B----?-------------------------------f---
----------------------|----------------------------T------------------------------To----E--X----------------------------------------------------?----o------X------------------------------------------f---
--------------BBB-BBBB|BB-B?----B-------?-o--------|-------TTo-BB----------BTBB-B-|----B?-B-------------BBBB----BBBB?B???-o-------BXXBBBBBBBBB--------T------------------------------------------------f---
----------------------|----------------------------|-------||T--------------|--o--|-----T-------------------------------------------------------------|-o----------------------------------------------f---
---------------?------|--o-------------------------|-------|||X-------------|-----|-----|----------------------------------o------?---------o---------|--------------------------?---------o-----------f---
m---------------------|----------------------E-----|-------|||--------------|-----|-----|--------------------------------o----------------------------|------------------------E--E--------------------X---
XXXXXXXXXXXXXXXXXXXXXXXXXXXXXXXXXXXXXXXXXXXXXXXXXXXXXXXXXXXXXXXXXXXXXXXXXXXXXXXXXXXXXXXXXXXXXXXXXXXXXXXXXXXXXXXXXXXXXXXXXXXXXXXXXXXXXXXXXXXXXXXXXXXXXXXXXXXXXXXXXXXXXXXXXXXXXXXXXXXXXXXXXXXXXXXXXXXXXXXXXXX
