-----------------------------------------------------------------------------------------------------------------------------------------------------------------------------------------------------------
--------X--------------------------------------------------------------------------------------------------------------------------------------------------------------------------------------------------
----------------------------------------------------------------------------------------------------------------------------------X------------------------------------------------------------------o-----
----o-----------------------------------------------------------------------------------------------------------------------o------------------------------------------------------------------------------
------------------------------------------------------------o--------------------------------------------------------E--------------------------------------------o------X---------------------------------
---------o--------o----------------------------------------------------------------------------------------BBB-BBXBBBBB------------------------------------------------------------------------------------
-------------------------------------------------------------------------------------------------------------------X--------------?----------oX---o----------------X----------------------o----------o-----
-----X---------------------------------o--------------------------------------------------------------------------------------o---X------BB------------------------------------------------------------v---
---------o------------------------------------------------------------------------------------------------------------o-------------------------o-----X-----------------------B-------------------o----f---
---------------B-----------------------o----------------------X----------------------------------------BBB-BBBBB--------------------------------------o-----------o-----?BBB--------o------------------f---
-------------------------------------------------------------------T--------------------------------------------------------------T-------o------------------------------------------------------------f---
-------------------XXXXX------------------------------------XXXXXXX|--------XXXXX----BBBBBBBB--------???????-----BBB--BBB-----B?--|------BB--BBXB------T-------X-?BB--BBBBBB--------------------o-----of---
-------------------------------------------------------T----------X|------T---------------T---------------------------------------|-----o--------------|-------------------------------o---------------f---
-------------------------------------X-------X---------|-----------|------|---------------|---------------------------------------|--------------------|-----------------------------------o-----------f---
m-E----------------------------------------------------|-----------|------|---------------|---------------------------------------|----EE----------E---|--------E----E---------------------------------X---
XXXXXXXXXXXXXXXXXXXXXXXXXXXXXXXXXXXXXXXXXXXXXXXXXXXXXXXXXXXXXXXXXXXXXXXXXXXXXXXXXXXXXXXXXXXXXXXXXXXXXXXXXXXXXXXXXXXXXXXXXXXXXXXXXXXXXXXXXXXXXXXXXXXXXXXXXXXXXXXXXXXXXXXXXXXXXXXXXXXXXXXXXXXXXXXXXXXXXXXXXXX
