-----------------------------------------------------------------------------------------------------------------------------------------------------------------------------------------------------------
-----------------------------------------------------------------------------------------------------------o------------o-----o----------------------------------------o--o-----------?--------------------
-----------------------------------------------------------o------------------B----------B-------------------o---------------------------------------------------------------------------------------------
---------------------------------------------------------o-----------------X-----------------------------------------------------------------o--X------------------------------o-----o---------------------
--------X---------------------------------------------------------------------------------B-----------------o--------------------------------------o----X--------------------------------------------------
--------------B------------------?---X--------------------------------X------------B-----B-----o---------------B--------------------------------?-------o-o-------------------X----------------------------
---------------o----------------o----------------X--------------------------------o-------------------------------------------------------------------------------------------o----------------------------
------------------------------------------------?---oo-----------------------------------------------------------------------o-----------------------------------------------------X-------------------v---
------o----------------------XXXXXX-------T-----------------------------------?-????-------XXX---XXX------XXXX--------------X------------------------------XXXB----o--------------?--------------------f---
------------?-----------------------------|------------------------------------X------------------------------------------X----------------------XXXX-------------???????B-----------------------------f---
-------------------------XXXXXX-----------|----------------o----------------------------------BBX--BBBBB-----------------o----------------------o-----------------o-------X----------------------------f---
-o-------------------o---------o----------|-----o----XXXX-----------------------------o-------XXXXXXX-----------XXXXXXXXX-------------XXXXXXXX-------------XXXX----------------------------------------f---
-------?--------------------o--------o---?|XXX----------------------------X---------------o------------------------------------------------------------------------X-------o----------o-------B--------f---
--------o---------------------------------|------------------------------------------------------------------------------------X-----------------------------------------------------------------------f---
m-----------------------------------------|------------------E-------------------------------------------E---------------------------E---E--------E---------------------------------E------------------X---
XXXXXXXXXXXXXXXXXXXXXXXXXXXXXXXXXXXXXXXXXXXXXXXXXXXXXXXXXXXXXXXXXXXXXXXXXXXXXXXXXXXXXXXXXXXXXXXXXXXXXXXXXXXXXXXXXXXXXXXXXXXXXXXXXXXXXXXXXXXXXXXXXXXXXXXXXXXXXXXXXXXXXXXXXXXXXXXXXXXXXXXXXXXXXXXXXXXXXXXXXXX
