-----------------------------------------------------------------------------------------------------------------------------------------------------------------------------------------------------------
-----------------------------------------------------------------------------------------------------------------------------------------------------------------------------------------------------------
-----------------------------------------------------------------------------------------------------------------------------------------------------------------------------------------------------------
-----------------------------------------------------------------------------------------------------------------------------------------------------------------------------------------------------------
-----------------------------------------------------------------------------------------------------------------------------------------------------------------------------------------------------------
-----------------------------------------------------------------------------------------------------------------------------------------------------------------------------------------------------------
-----------------------------------------------------------------------------------------------------------------------------------------------------------------------------------------------------------
-------------------------------------------------------------------------------------------------------------------------------------------------------------------------------------------------------v---
-------------------------------------T---------------------------------------------------------------------------------------------------------------------------------o-------------------------------f---
-------------------------------------|-----------------------------------------------------------------------------------------------------------------------------------------------------------------f---
-------------------------------------|----------------------------------------E----------------------------------------------------------------------------T-------------------------------------------f---
----------------------------XXXXXX-XX|X--------------------------------------XXXXX---------------------XXXXX-------------XXXXXXXXXXXX------BBB------XXXXX--|-----------???????-------------------------f---
-------------------------o-----------|-----------------------T------o--------------------------------------------------------------------------------------|-------------------------------------------f---
-------------------------------------|-----------------------|---------------------------------------------------------------------------------------------|-------------------------------------------f---
m-------------------E----------------|-----------------------|---------------E-----------------------------------------------------------------------------|-------------------------------------------X---
XXXXXXXXXXXXXXXXXXXXXXXXXXXXXXXXXXXXXXXXXXXXXXXXXXXXXXXXXXXXXXXXXXXXXXXXXXXXXXXXXXXXXXXXXXXXXXXXXXXXXXXXXXXXXXXXXXXXXXXXXXXXXXXXXXXXXXXXXXXXXXXXXXXXXXXXXXXXXXXXXXXXXXXXXXXXXXXXXXXXXXXXXXXXXXXXXXXXXXXXXXX
