-----------------------------------------------------------------------------------------------------------------------------------------------------------------------------------------------------------
--X------------o---------?----------------------------------------o----o-----------?BB-B-BX-------BX?--------------------------------------------------o----o----------------------------------------------
------------------------------------------------------------------------------------X----------------------------o-B-BBBB-----------------------o------------o---X-------------------------o---------------
----------------------------X---------------------------------------------------------BBBX--o----------------------------------o----------------------o---o------------------------------------------------
--------o----------------------X------BBBBBBB-o-X--------o-------------------XBB-E----------B-BB-------o-------------------------------------BBB--------XXX----?----o--X--------------o-B------------------
---------------X----?---------------------------------------BBBBBB--------------BBB-------------BB-BB-B--BBXo--------------o------?-------------------------------------------------X----------------------
--o-------------------o-----------------o-----------o-----------------------------------o-------------------o--B--B--BBBBBB-B---------------B-BX-----o------------XXXXX------------------------------------
-------------------X----------------B-----------------------BBB------------------E---BBBBB---??XX-----------o----------------------BBB--------E----BBBB?XB---------------------------------------------v---
----------------------BBXBXBB------------------------------------B-----------???B?BXo-------B----------------X-B---------------------------BBBBB------------------------XXXXX-XXX---------o------------f---
--------------------------------------------XXXXBX---------------------------------------------------oX--XX?----------BBB--------B-B----------T----------------BBBXBB?-----------------------------X---f---
---o-----------------------------------------------------------------------------E--------TE-----T---------o------------E------------------E-?|T-------------------------------------------------------f---
--------------BBBB--BBBX--BBB-------BBBXB--BBB---o----BBBBBBBBBXXXXB--BBBBBBB---BB--BB-o-?|B-B--B|B---B-B-BB-BB-----?B?-?---BB--BXBBBBBB--BBXB||BX-?------BBBB-BTB----BBBXBB---------------------------f---
---------B---------------o-----o---o----------------oB--------------------o---------------|------|---o----------------------------------------||----------------|------------------------?-------------f---
----------------------------------------------------------------o---------o---------------|o----B|--------------------------------------------||----------------|----------------------------------X---f---
m-E-------E-E-E--------E-------E--o--E-E---E----------------E------EE---EE--E-----E----EE-|E--E--|------------E---E------------E--EE-EE-E--E-E||-------E--EE--E-|----------------E-----E---------------X---
XXXXXXXXXXXXXXXXXXXXXXXXXXXXXXXXXXXXXXXXXXXXXXXXXXXXXXXXXXXXXXXXXXXXXXXXXXXXXXXXXXXXXXXXXXXXXXXXXXXXXXXXXXXXXXXXXXXXXXXXXXXXXXXXXXXXXXXXXXXXXXXXXXXXXXXXXXXXXXXXXXXXXXXXXXXXXXXXXXXXXXXXXXXXXXXXXXXXXXXXXXX
