-----------------------------------------------------------------------------------------------------------------------------------------------------------------------------------------------------------
--------------------------------------------------------------------------------------------------------------------------------------------------------------------------------o--------------------------
-----------------------------------------------------------------------------------------------------------------------------------------------------------------------------------------------------------
--------------------------------------------------------------------------------------------------------------------------------------------------?--------------------------------------------------------
-----------------------------------------------------------------------------------------------------------------------------------------------------------------------------------------------------------
-------------------------------------------------------------------------------------------------------------------------------------o---------------------------------------------------------------------
------------------------------------------------------------------------------------------o--------------------------------------------------------------------------?-------------------------------------
---------------------------------------------------------------------------------------------------------------------B---------------------------------------------------------------------------------v---
-------------------------------------------------------------------------------------------------?????-------------------------------------------------------------------------------------------------f---
-------------------------------------------------------------------------------------------------------------------------------------XXX---------------------------------------------------------------f---
------------------X--------------------o---------------------------------------------------------------------------------------------------------------------------------------------------------------f---
--------------------X--------XXXX--XXXXXXX-------XXXXXXX------------XXX---X--XXXXXXXX---------XXX?XXX----------XXX-XXXXXXXX--XXXXXXXXXX-XXXXX---------T----T-------------------------------------------f---
------------------------------------------------------o----------------------o------------------------------------------------------------------------|----|-------------------------------------------f---
----------------------------------------------------------------------------------------------------------------------------------------------------o-|----|-------------------------------------------f---
m-------------E-------------------------------E------------------------E-----------------------------------------o------------------------------E-----|----|-------------------------------E-----------X---
XXXXXXXXXXXXXXXXXXXXXXXXXXXXXXXXXXXXXXXXXXXXXXXXXXXXXXXXXXXXXXXXXXXXXXXXXXXXXXXXXXXXXXXXXXXXXXXXXXXXXXXXXXXXXXXXXXXXXXXXXXXXXXXXXXXXXXXXXXXXXXXXXXXXXXXXXXXXXXXXXXXXXXXXXXXXXXXXXXXXXXXXXXXXXXXXXXXXXXXXXXX
