-----------------------------------------------------------------------------------------------------------------------------------------------------------------------------------------------------------
---------o-------------------o---o-----o-----------------XB--B--------------------------------------------o---o---o---------------X------------------------------------------------------------------------
--------------B---------------------------------------o-o--X------o---------X------------------------------o---------o------o--o-------------------------------------------------------------B-------------
--------------------------o---------------------------------------------B-BX--------------------------X-XB-------------------------XB----------------------------------oo----X--------------o----o---------
----?--------------------------------o-------------------X----------B-------------------------------------o--------------------------o----B--------------------------------------------------o-------------
------X----o-----X-------?X?X?-o------------o--------B-----------B-----BBX-------------B-B------B-B----B-----------X---X--XX?--------------X-B-B-BX----X---------X----oX-------------?---------------------
---------------------------------------X----------------------------o----------------------X--------------------------------------o--BBB--B-----------o-----------BB-BBX------------o----------------------
-X------------------??------------------------------------------------------BB--------------X-XX---o-------B----------o--B-B------o-------o----------------------------o------------------------------ov---
-o-oo---o------o-----------------?-o---------------oXX--------------------------------------------XXX----------------o-----o---------B--BBB-?-----o------------XX-XX-------------?---------------------f---
------------------------------------------------------B--------B----BB-------X-Xo--------------------------------B---BBBB----?-------------o------oB-BB------T------------o----------------?-----------f---
--o----------?-----------------------o--------------o-----------X--------------T-o-------------------------------o-----T----oo---X---o-------------------X---|-----------------------------------------f---
--oo---------o-----B-B--B----T---XXXXX--------BB---BB----------------BB----B--B|------------B--BB?--XBB-BX-BBB--XXX---B|----BX-XBBX--B-XB-B-----BB------B-BBB|o----------------------------------------f---
-------------------o--------o|----o--------------------------------------------|------------------------------B-T------|o-----B--------------oo--------------|T-------o--o------------o----------------f---
-----------------------------|----------------o-------------------------o------|--------------------------------|----o-|---X---------------------------------||-------o-------------Xo------X----------f---
m-E----E---------------------|-------------E-----------------------------------|--------E-----------E-----------|------|-------------------------------------||---E------------------------------------X---
XXXXXXXXXXXXXXXXXXXXXXXXXXXXXXXXXXXXXXXXXXXXXXXXXXXXXXXXXXXXXXXXXXXXXXXXXXXXXXXXXXXXXXXXXXXXXXXXXXXXXXXXXXXXXXXXXXXXXXXXXXXXXXXXXXXXXXXXXXXXXXXXXXXXXXXXXXXXXXXXXXXXXXXXXXXXXXXXXXXXXXXXXXXXXXXXXXXXXXXXXXX
