-----------------------------------------------------------------------------------------------------------------------------------------------------------------------------------------------------------
-----------------------------------------------------------------------------------------------------------------------------------------------------------------------------------------------------------
-----------------------------------------------------------------------------------------------------------------------------------------------------------------------------------------------------------
-----------------------------------------------------------------------------------------------------------------------------------------------------------------------------------------------------------
-----------------------------------------------------------------------------------------------------------------------------------------------------------------------------------------------------------
-----------------------------------------------------------------------------------------------------------------------------------------------------------------------------------------------------------
-----------------------------------------------------------------------------------------------------------------------------------------------------------------------------------------------------------
---------------------------------------------------------------XXXXX-----------------------------------------------------------------------------------------------------------------------------------v---
------------------------------------------------------------------------------------------BBBBBB-------------------------------------------------------------------------------------------------------f---
---------------------------------------------------------------o---------------------------------------------------------------------------------------------------------------------------------------f---
-------------------------------------------------------------------------------------------------------------------------------------------------------------------------------------------------------f---
---------------------------------------------------------BBBBBBB--------?????-------BBBBBBBB---XXXXX-XXXXX---------------------XXXXX----XXXXXXX---T----------------------------------------------------f---
----------------------------------------------------------------------------------------------------o---------------------------------------------|----------------------------------------------------f---
------------------------------------------------------------------------------------------------------------------------o-------------------------|----------------------------------------------------f---
m-------------------------------------------------E-----------------------------------------------------------------------------------------------|---E------------------------------------------------X---
XXXXXXXXXXXXXXXXXXXXXXXXXXXXXXXXXXXXXXXXXXXXXXXXXXXXXXXXXXXXXXXXXXXXXXXXXXXXXXXXXXXXXXXXXXXXXXXXXXXXXXXXXXXXXXXXXXXXXXXXXXXXXXXXXXXXXXXXXXXXXXXXXXXXXXXXXXXXXXXXXXXXXXXXXXXXXXXXXXXXXXXXXXXXXXXXXXXXXXXXXXX
