-----------------------------------------------------------------------------------------------------------------------------------------------------------------------------------------------------------
-----------------------------------------------------o-----------------------------------o-----------------------------------------o--------------------------------------------------------------o--------
-?----------------------------------------------o-----------------------------X------------------?------------------------------------X---------o--------------------------------------o---------o---------
-------------------------------------------------------------------?---------------------------------------------------------------------o---------X---------------------------------------------X---------
-------------------------X--------------------------------------------------B-------------------------X-----------------------------------------------X----------------------------------------------------
---------------------o-----X---------------------------------X--------------------X-X------------------------------B-------------------------------------????-------------------X--------------------------
-----------------X-----------------------X---o-o----X------------------X------------------------o---------------X-------------X----------------------------------------X---------o-------------------------
------o---B------------------------------------------o----------------BBBB-XBo--------o------------------------X----------------------------o--------BBBBBXB----------------------------o--------------v---
---------------------------o---------------X--------X---------------------------------------------------------?--oBBBBBBBB------------------BB---------------------------------------------------------f---
------------------X--------o-------------------BBBBBB------------------------------------------------BXXXBBB------------------------o------------------------------------------------------------------f---
----------------------------------------------------------T--------o-----------T----------------------------------------------------T-----------------------------o-------------------------o---X------f---
----------------------o------------T-BBB-----BXBBBB-------|-------BBBBB?---BBBX|-????----------BBBBXXXX---o----????-----------------|--o---T--BBB--XX??---BBBBBB---------------------------------------f---
-------?------------T--------------|---------------------T|----X---oo-o--------T-------T------T----o---------------T----------------|------|--------------------------------------------o----B---------f---
--------------------|----o---------|---------------------||o-------------------|---?---|------|-o------------------|----------------|------|--------------------------------------------------------?o-f---
m--E----------------|-E------------|---------E-----------||--------------------|------E|------|-------------E------|----------------|------|--------------------------------------------------E--------X---
XXXXXXXXXXXXXXXXXXXXXXXXXXXXXXXXXXXXXXXXXXXXXXXXXXXXXXXXXXXXXXXXXXXXXXXXXXXXXXXXXXXXXXXXXXXXXXXXXXXXXXXXXXXXXXXXXXXXXXXXXXXXXXXXXXXXXXXXXXXXXXXXXXXXXXXXXXXXXXXXXXXXXXXXXXXXXXXXXXXXXXXXXXXXXXXXXXXXXXXXXXX
