--------T-B-?---B----------ET---E---??---?----E----||-----E|----------X---X--------X------MX|------|?-E-X------X------------T----|-?B--E|MB---B-----oT-----M?-----E----?-E--X--------M--X--T--E-B----o--
---------------TEE-----T---M-----B-B----oB--|---M-To-----------BoME-B----B----o---------M--------------TT-----B--?-----|---?----|X-----------o------X-E-----EB-----M---------o---o----|-E------------B--
-E-------E---M----M--o--T-X----M-X----TX-BT-B---o-|XT---M-M--E-------E---B---M--------B-?-X--B---M---|E--------B-|--------------M------X--------X--M---M--------T--T------M-X--B------------o--------T--
----?----T----T-B---------E---Bo---------o-----M-------M-------------X------------X-o----X--M-T??---o|--o------T-------B--M-o--|----------E----T------------------------|---|----?--X----To-----X-------
-----T-E----|----X------M-|---------E-----T---------E---------|---X--?--?-B---E----E---To---X-M----------oT-----T|B-------E--------T---------|--------B---T--T--------oM-------X-----B--M-----------?X--
----------------o-------X---o----?-------------M--o-----E--------M---------E------o-------E-B?E--T----B-?-o---?--------?---X-X------------E-T----?-----M|----T----M--|-------X-T--------------o-o--|?---
-------o-TX------B---||-|----B--B?--E-?-o-o|?-----M---X---T-----M--o-----------o------?o-??-?E--------------|-T-----M-----------------TB---E-------X|------M--------X--|----?B-E-----?|----oXX----------
--o|B?B----------|-T-------B-?-?-----------E--------------T--B---T-B--T-T--o-----B------|---?----E--------E-------M-----------o|E-----------B-M|--------------|--E----BM-T-?-----|---------?------X----v
-o-------ToT--------MB----------|------B----ME---T----B--ToTB---B-T--B-M-X----M----?------T-E----X----------M--BM-T-T----T-B---M--E-X-M---o-----TM------------o|--B--------?T-B-M----E-X-------------X-f
--M----E-B-----EXB----------------------B-o-X---?--oX--B------------|--|--X-X?-X---------?--|----X-------B---X-B----o-T---T----------o-X-E------------|----------M--X--|---M?--B-------M-B---XT|E---T--f
--|B-T--------To--T-T--X-?----X?----------?---MM------------o------|---M---|B-----X-X-|-----------|-----|---?----M-E---??-----M-------o-----------T----o-|--?----?------B-------------?---X--To?-T-TB--f
-------M--o-TE-X--------------?----T----------?------X------------M?--|-Eo---?--------B--E-|--------B-o------X--|-----------B------T-?--B-M-----------|-B-o--o----M-------------B-TT-----BT-XX---|--E--f
----B-------B---X----?-----TB-MX--oE--------M-X-o-------?-------E---o---E-----T-----B-B-----EE--------------------------|?-?------MX------TM---|--B--|----|--XBM---o?---E---------B---------------T----f
----------TE----T------------B--------o---X-|-----X---o----|---?-----M-------X------oBX--?-------MEX-MX---------------------------MB--E-oo-|-TX----------?--M-------B--o-------oX-------o|-EBE-EX-----Mf
m---|B--M--M-----|--------M|------T---------o-B-X-M---?---|----T----T-----|-X-o-E-T-X---B-----M-EM-|-o-T--------B---------B-T|-T------MTX-----B------o-----|--ME----X--------E----|-----T-T--?-----B---X
XXXXXXXXXXXXXXXXXXXXXXXXXXXXXXXXXXXXXXXXXXXXXXXXXXXXXXXXXXXXXXXXXXXXXXXXXXXXXXXXXXXXEXXXXXXXXXXXXXXXBXXXXXXXXXXXXXXXXXXXXXXXMXXXXXXXXXXXXXXXXXXXXXXXXXXXXXXXXXXXXXXXXXXXXXX|XXXXXXXXXXXXXXXXXXXBXXXXXXXX
