--------T--E--X-------oT-------EM---B----------?--|T----ME?-o----E-|X-o--?----o---X---X-o----------?------------o-|---M-?---B---XX-o-o------|--E-|--?-Mo-|---o?---X-o-----o-X----|-----EEo------E-----?-
----B----------|----?B-----------M-------------T-MEo----------?---X-----X-------------o|-?--|X----M----E-M------E-o-o-T---M-?----B-----X-oE----------o------|-?----TX-?-----o------|--|----XBo--?----?--
-B---|--------------------T-M-------o--o-----E---M----X-BB---E-----B----T------T------o--------o-----X-----------?B----------E--E?E-o---?-?M---?o----------------------T---T----------TT-----E?-M----|--
-E--------X---T----?--M-----X---------B?X-----?--|-----M?--|--|--|-o--------XM-----X---X-------BMT--o-------?------o----EM--M-----T-E-----?--M--------------------X-M------------o--E-?-----------------
-TM|M-------|E----------TB----|M-M-|----------XM--E----E-----TX-X---?----X---?o-M-X-E----T---E-----------T?----|-?T--EEEoT?-------E----------------?---?--X-MX----o-----|---?X----E-E-M------o---|?-E---
-------M-------M-E--o----o-|?--------o-------------M|---------E--M?-----------|T-----M----M-TM--?-|-|M---TM------B?-|-|-E---------M-----X-BE-M?-M-|--M----TE--------------|-BM---o|?M---T------B---T----
-------B----EM-B-------oM-|o--|---------|------EE----------B--X----oXEE-E--T-E--------M?-ET-----M---?-?--X-?B--B---B--E-----o-ME-E----o-E|------B-----o-|X--M----MoB--?|--------|-T-----B--ME-----------
-o------|-----T------------M--o----------------?---|---?---?--------B-o-----|--------X------o------EE--E----|-M-X--X--------------BT|-M---?--|-X|-----E-M-----X----E--Xo-o------o---M-------|----------v
----B--------T-----?--|---|-X-----TE--?|----------o-T---?-----------T---T-------o----------X-E-E-?-B-o?---------E--T--E-----?-?-------MET-------?-?-o-oT-B|M-------X------?-------|----?----------T----f
----------TX-------M-E--|---E-M--X-E---------X----M|--------E---|--X--------E---M--M-X--------X----M-----M----T---------T-----?B---BX---------M--------o-M----------E-T--T-?------M-|------|---X--XBE--f
----o-oM--MT-M-M----M-E-------?---|----------B---o---------B-?-XoM----------------o--?|T----E-----EM--T|-----T-M-MX---B--M------------o|----------o--?X---X--B---E-----M--X-----?-?--TT--E-------X--|-?f
---------M-?o---o?-B----E------B--E--T--X----?--E----|-M---oo----------oM--T-----?-------E--M|---------B-----?---M|----E-?-------M-----------------------------------------|--X?-----------X|----------f
-X---X---B|-----E-o-E----?-M--?M----------B---E---M--?----------E-o-o--TXE---o-o--|--|-E--MT??-X----o-------T-----?----o-------T------?--------oE-T--------B-E----------------X--X-------o-?-?-----B---f
-------------M---XBo-----------X-B---T-----------o-M--B----------T-----------E-T-------------T-----MB------B----o-----X----|--TE----E--?----|---|--E----B--?--X-----E-M--T|----TB-------------T|X-o----f
mB--E-?-|---MX--X-T-M-----o-?EE-------|-o----o?-M-?-oo------BT|-----E-E-----TB-----BMEEX---|---E--|----X------?-E-----T----|---BM----------X--X------E|--------E---T-------B---?-oB--?EE--------T----o-X
XXXXXXMXXXXXXXXXXXXXXXXXXXXXXXXXXXXXXXXXXXoXXXXXXXXXXXXXXXXXXXXXXXXXXXXXXXXXXXXXXXXXXXXXXXXXXXXXXXXXXXXXXXXXXXXXXXXXXXXXXXXXXXXXXXXXXXXXXXXXXXXXXXXXXXXXXXXXXXXXXXXXXXXXXXXXXXXXXBXXXXXXXXXXXXXXXXXEXXXX
