-----------------------------------------------------------------------------------------------------------------------------------------------------------------------------------------------------------
---------------------------------------------------------XB--B--------------------------------------------o---o---o---------------X------------------------------------------------------------------------
-------------------o---------------------------X------o-----------o---------X------------------------------o----------------o----------------------o-----------------------------------------X-------------
------------------o-----------X-----------------------------------------B-BX--------------------------X-XX-----------------------------o--o--o---------------------------------------------------o---------
-----B----?o------------------------BXo--B---------------X----------B-------------------------------------o--------------------------------------------------------B--BBXB---------------------------------
---------------------?------------------------o------X-----------------BBB----B--------B-B------B-B----B-----------X---X--XX?---------X--BXBX----------?---------------------------X-?--o------------------
----------------------------------------------------------------------------------------------------------------------------------o--------oE----------------------B-----X---------------------------------
---?-------------------B------XXBXBB---o------------------------------------XB--------------X-XX---o-------B----------o--B-B--------BBBB-B-BB-B-B------------o-?---B-B--------o-------o----------------v---
----------o----------X-----X--o---------o-----------XX--------------------------------------------XXX----------------o-----------o--o---------------------------------X--------------------------------f---
---------------------------BBB---o-----------------o--B--------X----BB-------X-X---------------------------------B---BBBB----B---o-----X-XX-----BBB-BB------B------o---o-------X----X--X---?-----------f---
-------------------------T-------o------------------o--------------------------T-o-------------------------------o-----T----oo-------o-----------------------------------------------------------------f---
------------------------B|BBXBB---------------BB---BB----------------BB----B--B|------------B--BB?--XBB-BX-BBB--XXX---B|----BX---BB-X-XX--------?X?------o----BB?B-------------------------------------f---
-------------------------|-TB-------------------------------------------------o|------------------------o-------T------|o-----B-T-----------------------------T--------------------o--o----------------f---
-------------------------|-|------------o-------------------------------o------|--------------------------------|----o-|--------|-----------------------------|----------------?-----o------X----------f---
m-E----------------------|-|---------------E-----------------------------------|--------E-----------E-----------|------|--------|----E------------------------|----------------------------------------X---
XXXXXXXXXXXXXXXXXXXXXXXXXXXXXXXXXXXXXXXXXXXXXXXXXXXXXXXXXXXXXXXXXXXXXXXXXXXXXXXXXXXXXXXXXXXXXXXXXXXXXXXXXXXXXXXXXXXXXXXXXXXXXXXXXXXXXXXXXXXXXXXXXXXXXXXXXXXXXXXXXXXXXXXXXXXXXXXXXXXXXXXXXXXXXXXXXXXXXXXXXXX
