-----------------------------------------------------------------------------------------------------------------------------------------------------------------------------------------------------------
-------------------------------------o---------------------------------o-------------------o---o---------------------------------------------------X------------o-----------B------------------------------
------------------------------o-----------------------------o---------------------o--------------------o-------------------o----------------------------o----------o-X--o---------------------------o------
-----------------?----------------------------X----------------------------------------------------------------------------------X---------o-------------------X---------------o---------------------------
------------X------------------------X----------------X--------------------------------------BXB--BB----------------------------------X----------------------------o---------------------------------------
-------B--------------------------o-X----o-------------------X----------------------------------------------------------------------------X----------X------------------------------X----------------------
---------------?--o-----------------------o----o------o-------------------------o-----------------o----o----o-----------o----B----------------------------------X----o----------------------o--------------
-----------------B------------------------------X---------------------------X----------BXBBBB-B------------X--------o----------------------------------o-B---------------X-----------------------------v---
-o-------------o----------B---------------------------------BB------------BBBB-XB-------------------------------------??----o-?-----------------------------------------------------X-----------o------f---
--------------------oo---o----------T----------------------B--X----------------------------------o---------BBB------------------T-------------------------------T-X--------------------------o---------f---
------------------------------------|----T-----?------T--------o---------o-o----------------------o--T----------------?---------|-------------------------------|----------------------X---------------f---
----X------------------------------X|B-BX|----?----B--|--o--B-XB-BT-o----B-----------XXXXX-----------|----oo--------BBBB-------X|B---XX-BB--------o--------BBBBB|---------------------------------o----f---
--------------B-----------o---------|----|-T----------|-----------|------------------------o------T--|---TT-oo--------X---------|--------------------T----------|-----------------X----o---------------f---
------------------------------------|----|-|----------|--------o--|--o--------B---------------o---|--|---||---------------------|--------------------|----------|-----------------------B-------o------f---
m-----------------------------------|----|-|----------|--o--------|--o---------------E------------|-E|---||---------------------|--------------------|----------|--E----------------------------E------X---
XXXXXXXXXXXXXXXXXXXXXXXXXXXXXXXXXXXXXXXXXXXXXXXXXXXXXXXXXXXXXXXXXXXXXXXXXXXXXXXXXXXXXXXXXXXXXXXXXXXXXXXXXXXXXXXXXXXXXXXXXXXXXXXXXXXXXXXXXXXXXXXXXXXXXXXXXXXXXXXXXXXXXXXXXXXXXXXXXXXXXXXXXXXXXXXXXXXXXXXXXXX
