-----------------------------------------------------------------------------------------------------------------------------------------------------------------------------------------------------------------
----------------------------o-------------------------?----------o--------------------------------------------------------------------------------------------------------------------------------o--------------
-----------------------------------------------------------------------------------------------------X--------------------------------X---------o--------------------------------------o-------------------------
---------------------------------------X-----------------------------------------------------o-------------------------------------------o---------X---------------------------------------------X---------------
------------?-----------------------------o-o----------o---------------------------------------------------------------------------------------------------------------------------------------------------------
-------oo---------------o--------------X------------------------------?-----------X--------------------------------B-------------------------------------????-------------------X--------------------------------
-----------------------X-----o---------------------------o--------------------------------o--B----------------B---------------X----------------------------------------X---------o-------------------------------
------X------------------------------------------------------o--------------------BBBBBBX--------------------oo-----------------------------o--------BBBBBXB----------------------------o--------------v---------
------------------o------?---------X-----------X-----------T-XB-B-------------------o-----------X--------o---------BBBBBBB------------------BB---------------------------------------------------------f---------
-----------o--------------o-------------------------o------|---o----------------------------T-------------------X-------------------o------------------------------------------------------------------f---------
------X-------------------------------T---o-----------T----|-------------------------------E|---------------------------------------T-----------------------------o-------------------------o---X------f---------
----------BXXBB-BB--------------------|------B--B-BB--|--BB|B----B--B-X-------BBBB?XB-BBBBBB|--??X?---BBBBBBBB----?-----------------|--o---T--BBB--XX??---XBBBBB---------------------------------------f---------
--------------------------------oT----|--o----------T-|----|--------T------o----------o-----T----------------------T----------------|------|--------------------------------------------o----B---------f---------
---------------------------------|o---|-------------|-|----|--------|-----------------------|--------------------o-|----------------|------|--------------------------------------------------------?o-f---------
m--o-E---------------------------|----|-------------|-|----|--------|-----------------------|----------------------|----------------|------|--------------------------------------------------E--------X---------
XXXXXXXXXXXXXXXXXXXXXXXXXXXXXXXXXXXXXXXXXXXXXXXXXXXXXXXXXXXXXXXXXXXXXXXXXXXXXXXXXXXXXXXXXXXXXXXXXXXXXXXXXXXXXXXXXXXXXXXXXXXXXXXXXXXXXXXXXXXXXXXXXXXXXXXXXXXXXXXXXXXXXXXXXXXXXXXXXXXXXXXXXXXXXXXXXXXXXXXXXXXXXXXXX
