-----------------------------------------------------------------------------------------------------------------------------------------------------------------------------------------------------------
------------------------o-----------------------------------------------------o----------------------o---------------------------------------o------------------o---------------o----o--?------------------
----o-----------------------------------------------------------o-----------------------------------------------------------------------------------------------------X------------------------------------
---o----------------------o?--B--------------------------------------------------X-------------------------------------------------------------------------------------------------------------------------
----------o-------------------------------X------------------o-----X-------------------------X--------------X-X----X----------------------------o----------------------------------------------------------
------o--------------------------X-----------------o-------X--------X--------------X----?-----------------------------X-XXXX------X-----------------------------o-X----------------------------------------
-------o----X-----?----?o---------------------------------------------------------------------------------------------o-----------------?----------------------------------------------X-------------------
-B--------------------------------------------------------------------------------------------------------XXXX----XXX-XX-----------------------XBX----------o-------------------------------B----------v---
---o--------------------------------------------B-------XXX----------------------------------------------------------------------------------------o-------------------B-???-?X----------------o-------f---
-----------------o----------X---------------------------------BBBBBBB----------------X-B----------------------------------X------------------------------------------------------------o---------------f---
----------o----------o----------------------------------------------o---------------------------------------------------------o------------------------------------------------------------------------f---
------B------------------XBXXX-o-XXXXX-----XXXXXXXX-B--XXX------XXX-X-----------------XXX------X-XXXB--XX-X-o-----X---XXX----------------------XXX--------------?-?-??-?-------------------------------f---
------------------o------------------------------------------o-----------------------------------------------------------------------T-----------------------------------------------------------------f---
-------------------------------------------------------o-----------------------------------------------------------------------------|------------------------------o----------------------------------f---
m------------------------------------------------E-------------------------------------------E---------------------------------------|-----------------------------E--------E--------------------------X---
XXXXXXXXXXXXXXXXXXXXXXXXXXXXXXXXXXXXXXXXXXXXXXXXXXXXXXXXXXXXXXXXXXXXXXXXXXXXXXXXXXXXXXXXXXXXXXXXXXXXXXXXXXXXXXXXXXXXXXXXXXXXXXXXXXXXXXXXXXXXXXXXXXXXXXXXXXXXXXXXXXXXXXXXXXXXXXXXXXXXXXXXXXXXXXXXXXXXXXXXXXX
