-----------------------------------------------------------------------------------------------------------------------------------------------------------------------------------------------------------
---o----------------------------B--------------------------------o-------------------------B------------------------------------------------------------------o-o------------------------------------------
-B--------------------------------------------------------o---------------------------------------------------o--------------------------------------------------------------------------------------------
--------------------------------------------------------------------------------------------------o-------o-----------------------------------------------------------o------------------------------------
---------------------------------------------------------------------o-------------------------------------------------------------------------------------------------------------------------------------
------------o-----------------------------------------------------o---------------X-----------X------------o------------------------o--------------o-o------------------?----------------------------------
----------X---------------------------------------------------o-----------------------------o---------------------------------------------------------------------------X----------------------------------
------------------------------------XXXXXXX-------XXX----------------------BBBBXBBB------------------XXXXXXX------------------------------------------o-BBBBBB-----------------------------------------v---
------------------------------X----------------------------------------------------------------XXXXX---------------------------------------------------------------------------------------------------f---
-----------------------------X----------------------------------------------------------------------------------XXXXB?X--------------------------------------------------------------------------------f---
-------------------------------------------------------------B-------------------------------------------------------------------X---------------------------------------------------------------------f---
-----------------------------XXXXXX-XXXXX--------XXXXXXX----------BBBBBBXXXXXXXX-----???????--XXTXXXX?--XXXX-XXXXXX-------------------XXXX------XXXXXX?XXX-------XXXXXXX-------------------------------f---
------------------------------------------------------------------------------------------------|----------XX-------------------------------------------------------------------o----------------------f---
--------------------------------------------------------------------X---------------------------|----------------------------------o-----------------o-----X-------------------------------------------f---
m-----------------------------------E-----------------------------------------------------------|-----------E--E-----------E-------------------------------------E------------------------------E------X---
XXXXXXXXXXXXXXXXXXXXXXXXXXXXXXXXXXXXXXXXXXXXXXXXXXXXXXXXXXXXXXXXXXXXXXXXXXXXXXXXXXXXXXXXXXXXXXXXXXXXXXXXXXXXXXXXXXXXXXXXXXXXXXXXXXXXXXXXXXXXXXXXXXXXXXXXXXXXXXXXXXXXXXXXXXXXXXXXXXXXXXXXXXXXXXXXXXXXXXXXXXX
