-----------------------------------------------------------------------------------------------------------------------------------------------------------------------------------------------------------
-----------------------------------------------------------------------------------------------------------------------------------o-----------------------------------------------------------------------
-----------------------------------------------------------------------------------------------------------------------------------------------------------------------------------------------------------
----------------o-------------------------------------------------------o-------o-----------------------------------------------------------B--------------------------------------------------------------
-------------------------------------B-----X-------------------------o----------------------------------------------------------------------------------------------------------X--------------------------
--------------------------------------------------------------------------------------------------------------------------------------------------------------------B--------------------------------------
-----------------------------------------------------XXXX----------------------------------XXXXXX---------X----------------------------------------------------------------------------------o-------------
---------------------XXX---------------------XXXXXXX----------------------------------------------------------------------------------------------------X-------o--------X----------------------------Xv---
-------------------------------------------------------------------------------------------------------------------------------------------------------------------------------------------------------f---
----------------------------------------------------------------------------------------------o--------------------------------------------------------------------o-----------------------------------f---
------------------------------------------------------------------T--------------X---------XXXXXX------------------------------------------------------------------------------------------------------f---
-------------------XXXXXXXX--------------XXXXXX-X-----------XXXXX-|-------------------XXX??----------------????--XXXXXXX--------XXXX-----------------XXXXXXX-------------------------------------------f---
------------------------------------------------------------------|------------------------------------------------------------------------------------------------------------------------------------f---
------------------------------------------------------------------|------------------------------------------------------------------------------------------------------------------------------------f---
m---------------E-----o-------------------------------------------|----------------------------------------------------------------E----E-------------E-------------------------------E----------------X---
XXXXXXXXXXXXXXXXXXXXXXXXXXXXXXXXXXXXXXXXXXXXXXXXXXXXXXXXXXXXXXXXXXXXXXXXXXXXXXXXXXXXXXXXXXXXXXXXXXXXXXXXXXXXXXXXXXXXXXXXXXXXXXXXXXXXXXXXXXXXXXXXXXXXXXXXXXXXXXXXXXXXXXXXXXXXXXXXXXXXXXXXXXXXXXXXXXXXXXXXXXX
