-----------------------------------------------------------------------------------------------------------------------------------------------------------------------------------------------------------
----------------------------------------------------------------------------------------------------------------------o----------------------o------------------------------------------o------------------
-----------------------------------------------------------------------------------------------------?----------------------------------------B------------------------------------------------------------
-----------------------------------------------------------------------------------------------------X-----------------------------------------------------------------------------------------------------
------------------------------------------------------------------o-----------------o----------------------------------------------------------------------------------------------------------------------
------------------?-------------X------------------------------------------------------------------------------------------------------------------------X-------------------------------------------------
-------------------------------------o---------------------------------------------------------------------------------------------------------------------------------------------------------------------
------------------------------------------------------------------?------------------------------------------------------------------------------------------------------------------------------------v---
-------------------------------------------------------------?--X-?-XXXX----------------------------------??????---XXXXXX-----XXXXX----------------o---------------------------------------------------f---
-----------------------------------XXXX-----------------------------------XXX-------BBBBBBB------------------XXXXXXXX--------------------------------------BBBB---------------------------------------of---
---------------------------------------------------------------------------------------XXX----XX?XX--------------------------------------------------------------------------------------------------o-f---
------------------------------------------------------------------X---------BBB----------------o-------------------------------XXX---------------------------------------------------------------------f---
------------------------------------o-----T--------????------------------------------XXXX-------------------XXXXXXXXX----------------XXXXXXXXX--------------------------------o------------------------f---
------------------------------------------|----------------------XXXXXXX------------------------------------------o-----------------------------------------???????--------------------X---------------f---
m-E---------E-----------------------------|-----------E-----------------------------------------------------------------------------E------------------------------------------------------------------X---
XXXXXXXXXXXXXXXXXXXXXXXXXXXXXXXXXXXXXXXXXXXXXXXXXXXXXXXXXXXXXXXXXXXXXXXXXXXXXXXXXXXXXXXXXXXXXXXXXXXXXXXXXXXXXXXXXXXXXXXXXXXXXXXXXXXXXXXXXXXXXXXXXXXXXXXXXXXXXXXXXXXXXXXXXXXXXXXXXXXXXXXXXXXXXXXXXXXXXXXXXXX
