-----------------------------------------------------------------------------------------------------------------------------------------------------------------------------------------------------------
------------------------------------------------------------------------------------------------------------------------------------------------------------------X----X------------------o----------------
--------------------------------------------------------------------------------------------------------------------------------o---------------------------------o---------------?----X------o------------
---X---------------------------------------------------------------o------------------------------------------------------------------------------------------o----------------o---------------------------
------------------------------------------------------------------o------------------------o-----------------------o------X------------------------------------------------o-------------------------------
------------------?-------------X---------------------------------------------------X-o--X----------------------X-----------------------o------------------------------------------------------------------
-------------------------------------o---------------------------------------------------------------------------------------------------------------------------------------------------------------------
------------------------------------------------------------------?------------------------o------------------------------------------------?----------------------------------------------------------v---
-------------------------------------------------------------X--X-?-XXXX------------X--------------------------------------------X---------------------------------------------------------------------f---
-----------------------------------XXXX-----------------------------------XXX------o----?????----------------XXX-----------------?-----------XXX-------------------------------------------------------f---
----------------------------------------------------------------------------------------------------------------------------------------------------T------------------------------------------o-------f---
------------------------------------------------------------------X---------BBB--------------------------o------------------------------------------|--------------------------------------------------f---
------------------------------------o-----T--------????------------------------------X---XXXXXXX------o--o---BBXXXXX--------------------------------|-Xo-----------------------o-----------------------f---
------------------------------------------|----------------------XXXXXXX-----------??BB?BBB-o----------------XXX--------------------XXXXX---XXXXXXX-|--------------------------------------------------f---
m-E---------E-----------------------------|-----------E---------------------------------------------------------------------------------------------|----------------E---------------------------------X---
XXXXXXXXXXXXXXXXXXXXXXXXXXXXXXXXXXXXXXXXXXXXXXXXXXXXXXXXXXXXXXXXXXXXXXXXXXXXXXXXXXXXXXXXXXXXXXXXXXXXXXXXXXXXXXXXXXXXXXXXXXXXXXXXXXXXXXXXXXXXXXXXXXXXXXXXXXXXXXXXXXXXXXXXXXXXXXXXXXXXXXXXXXXXXXXXXXXXXXXXXXX
