-----------------------------------------------------------------------------------------------------------------------------------------------------------------------------------------------------------
----------------------------o---------------------------B--------------o--------------------------------------------------------------------o----------------------------o---------------------------------
-----------------------o---------------------------------------------------------------------------------------?----------------------------------------------------------o--------------------------------
-----o--------------------o---------------------------------------------------------------------------o------------X-B-----------------------X---B----------X----------------------------------------------
--------------------------------X------------X----o-o-----o----------o---------------o--------BB-XBB-------------------------------------------------------------------------------------------------------
-------------?-----B-----------------------------------------X-------------------------------------------------------------------------------------?-----------------B-----------------------o-------------
---------------------o------------------------------------------------------------------------o--------------------------------------------------------------------------------------B------------oo-------
-----------B-------------o--------o?----------------------B------------------------------------------------------------BBBBXBBB-------------------------------o----------------------------------o-----v---
--------o---------------------o----------XBXX-XX-----------------------BBBB---------------o-B?B-----------------------?-------------------XB-------------------------------X------X--------------------f---
-----------------X------------?-o?o------------------------------------------------------------------------------------o----T---------BBB----BBB-------o-X---------B-----------------------------------f---
-------o-------X-------------------------------------------------------------T---------------T-----o-------T------T---------|-------Eo-----------------------------------------------------------------f---
------------------BBBBB-----BBB-T-------X---------------------BX-----X???----|-----BBB----BBB|----BBB-o----|------|TBBBB-BBX|BB----BBBBBBBB----------XBBX-BXB-T-----------------------------o-X--------f---
------------------------------oo|----------To------X-----------------------o-|---------------|-T-----------|---T--||--------|--T------------------------------|------------o-o-------------------------f---
--------------------------------|----------|------------------o--------------|------X--------|-|-----------|---|--||--------|--|------------------------------|---------------------------------o-o----f---
m------------------E---------E--|----------|--------------------E-----------E|---------------|-|-----------|---|--||--E-----|--|------------------------------|-----E----------------------------------X---
XXXXXXXXXXXXXXXXXXXXXXXXXXXXXXXXXXXXXXXXXXXXXXXXXXXXXXXXXXXXXXXXXXXXXXXXXXXXXXXXXXXXXXXXXXXXXXXXXXXXXXXXXXXXXXXXXXXXXXXXXXXXXXXXXXXXXXXXXXXXXXXXXXXXXXXXXXXXXXXXXXXXXXXXXXXXXXXXXXXXXXXXXXXXXXXXXXXXXXXXXXX
