--------------------------------------------------------------------------------------------------------------------------------------------------------------------------------------------------------------
-------------B---------------------B------------------------o----------------------------o------------------------------------------------------------------------------X-------------------------o-----------
------------------------------------------------------------------------------X---------------------------------------------------------------o---------------------------------------------------------------
---X---------------------------------------------------------------------------------------------------o-----------X---------------------B-o------------------------------------------------------------------
------------o-------------------o------------------X------o-------X---------B-------------------------X----------------------o--o-----------------------------------------------------------------------------
-----------------------X------------------X------------------------X--------------X-X---------------------o--------------------X-------------X------------?X?-------------------------------------------------
------------------------------------------------------------------------------------------------o---------------X--o---------------------------------------------------X--------------o-----------------------
----------------------B----------------------------------------------------XBo--------o------------------------X----------------X--------o-----------BBBB-BB------------------------------X------------v------
-------X---------?-----------------------X--------------------------X-----------------------------------------?--oB----------------------------------------------------------------------o-------------f------
-----------------------------------------------???X------BBBBBBB-------------------------------------BXXXBBB----------------------------------------------------------------------o--------------------f------
--------------------------B-------------------X--------------------------------T----------------------------------------------------To-------T--------------------------------------X-------o---X------f------
--------------------XBB--------XBXB-XBX--------BBB-----B?B-----XBXB----T---BBBX|-????----------BBB-XXXX---o----????---XBBBBX--------|------T-|-????X-??---BBBBBB----X-------------------------------o--f------
------------o--------------o-------------------------------------------|-------T-------T------T----o----------------------------o---|------|-|-------------------------------X-------------------------f------
-----------------------------------------------------------------------|-------|---?---|------|-o-----------------------------------|------|-|--------o-----------o------------------------------------f------
m----E-----------------------------E-----------------------------------|-------|------E|------|-------------E-----------------------|------|-|------------------------------------------------E--------X------
XXXXXXXXXXXXXXXXXXXXXXXXXXXXXXXXXXXXXXXXXXXXXXXXXXXXXXXXXXXXXXXXXXXXXXXXXXXXXXXXXXXXXXXXXXXXXXXXXXXXXXXXXXXXXXXXXXXXXXXXXXXXXXXXXXXXXXXXXXXXXXXXXXXXXXXXXXXXXXXXXXXXXXXXXXXXXXXXXXXXXXXXXXXXXXXXXXXXXXXXXXXXXX
