--------------------------------------------------------------------------------------------------------------------------------------------------------------------------------------------------------------
-----------------------------X--------------------------------------------------------------------o-----------------------------------------------------------------------------------------------------------
------------------------------------------------------------------------------------------------------------------------------------------------------------------------------------------------------X-------
----------------o------o------------------------------------------------o-------o---------------------------------------------------?----------------------------------------------o--------------------------
-------------------------------------B-----X-------------------------o-X------------------------------o---------------XXXXXXX-----------o---------------------------------------------------------------------
---------------------------------------------------------------------------------------------------------------------------------X-----------------------------------o----------------------------------------
----------------------------------------------------XXXX-------------------------o------------?----XXXX-------------------------------------------------------------------------------------------------------
-------------o-------XXX------------------?--XXXXXXX---------------------o------------------XXXXXXX-----------------XXXXXXXX---------------------------------------------------------------------------v------
-------------------------------------------------------------------------------------------------------------------------------------------------------------------------------------------------------f------
------------------------------------------------------------------------------------------------------------------------------X------------------------------------------------------------------------f------
------------------------------------------------------------------T--------------X-------------------------------------------------------------------------------------------------------------B-------f------
-------------------XXXXXXXX--------------XXXXXXXX-----------XXXXX-|-------------------XXX-XXX-----------------------XXXXX-o--------XXX-o-----------------------------------------------?---------------f------
------------------------------------------------------------------|------------------------------------T----------------------------------------------------------o-----o------------------------------f------
------------------------------------------------------------------|------------------------------------|-----------------------------------------------------------------------------------------------f------
m---------------E-----o-------------------------------------------|----------------------------------E-|--------------------------------E--------------------------------------------------------------X------
XXXXXXXXXXXXXXXXXXXXXXXXXXXXXXXXXXXXXXXXXXXXXXXXXXXXXXXXXXXXXXXXXXXXXXXXXXXXXXXXXXXXXXXXXXXXXXXXXXXXXXXXXXXXXXXXXXXXXXXXXXXXXXXXXXXXXXXXXXXXXXXXXXXXXXXXXXXXXXXXXXXXXXXXXXXXXXXXXXXXXXXXXXXXXXXXXXXXXXXXXXXXXX
