-----------------------------------------------------------------------------------------------------------------------------------------------------------------------------------------------------------
----------------------------------------o------------------------------------------------------------------------------------?---------------------------------?-----------o-------------------------------
---------o------------------------------------------------------------o-------o--------o-------------------o------------------o----------------------------------oX--X-------------------------------------
----------------------------------------------------------------------------------------------------------------------------------------------------o----------------------------------------------X-------
----o-------X?---------------o-----------B----------------------------------B---o----------o----------------------------------o---o---------------------------------o----------------------o---------------
---oX---------------------------------------X-------------------B?-----------------------X---------------?---------------------------------------?--------------o---o------X-------o-?---------------------
---------------?-------------------------------------------------------X-------o------------------------------------------------------------o-----------------o------------o-----------o-------------------
----X------------B--------------------X--------------------------------o-----o------------X---------------------X----------X----o----X----o-----------------------------------?---------o---------o----v---
---------------o------------o------------------------------X--------------------------------------BB----o------------------?---B-----------------------?-------------------------------------------X---f---
--------------X-----o-o-----------------------X----------------------------------o-----T-------o-X--------------------------------------o----------------------------------X---o-----------------------f---
--------------------------T---E-------------------------o----------T----------------o--|----------------o-------------o---------------o----------------------------------------------?--o--------------f---
----X------------------BBB|?BBBB--------------?-------------------T|-----------------BB|BBB-------?B--XBBTB----BBB---X-B----o---BB-BBB--o--T----------BBBX----------------X----------------------------f---
--------------------------|-X--------------------------------XT---||----T--------------|-----------------|----------o-------------o-------T|---o----------------T---------o-----------o----?-?---------f---
-----------------------o--|-------------------------------o?--|---||----|X-------------|-------------o---|---------Bo---------------------||------------o-------|-----B--------------------------------f---
m-------------------------|-----------------------------------|---||----|--------------|---E-------------|----------------------E---------||--------------------|--------------------------------------X---
XXXXXXXXXXXXXXXXXXXXXXXXXXXXXXXXXXXXXXXXXXXXXXXXXXXXXXXXXXXXXXXXXXXXXXXXXXXXXXXXXXXXXXXXXXXXXXXXXXXXXXXXXXXXXXXXXXXXXXXXXXXXXXXXXXXXXXXXXXXXXXXXXXXXXXXXXXXXXXXXXXXXXXXXXXXXXXXXXXXXXXXXXXXXXXXXXXXXXXXXXXX
