-----------------------------------------------------------------------------------------------------------------------------------------------------------------------------------------------------------
--------------------------------------------------------------------------------------------------------------------------------------------------------------------------------o----o---------------------
----------------------------------------------o----------------o---------------------------------------------------------------------------------------------X---------------------------------------------
---o-----------------B-------------------------o---------------------------o------------------------------------------------------------------------------------------o---o?-------------------------------
---------B-------------X---------------------------------------------------------------------X--------------X-X---------------------------X-----o----------------------------------------------------------
-----------------------------------?--------o---------------------------X----------X----?----------------------X------X-XXXX--------------------------------------X----------------------------------------
-X-----o-----------------------------------X--B------o-----------------o---------------------------------------------o-------------------------------------------------------------------------------------
-X--------------X-----------------X----------------------o--BXBBBB----?-----------------------------------XXXX----XXX-XX-----------------------XXX----------o-------------------------------B----------v---
-o-----------------------------------------------------------------------o--------------------------------------------------o----------------------o----------------o--?-X??-??----------------o-------f---
---------------------------o----o-----X----------------------------------------------X-B----------------------------------X------------------------------------------------------------o---------------f---
--------------------------------------------------------------------------------------------o-------------------------------------------------o------------------------o-------------------------------f---
---------------XX-----------------T------------------X-XXXB-XXXX?---------------T-----XXX---o--X-XXXX--XX-X-------X---XXX----------------------XXX--------------?-?-??-X-------------------------------f---
----------------------------------|---------------------------------T-----------|---------------------------------------------o------T-----------------------------------------------------------------f---
----------------------------------|---------o-----------------------|-----------|----------------------------------------------------|------------------------------o----------------------------------f---
m-----------------E---------------|---E-----E-----------------------|-----------|------------E---------------------------------------|-----------------------------E--------E--------------------------X---
XXXXXXXXXXXXXXXXXXXXXXXXXXXXXXXXXXXXXXXXXXXXXXXXXXXXXXXXXXXXXXXXXXXXXXXXXXXXXXXXXXXXXXXXXXXXXXXXXXXXXXXXXXXXXXXXXXXXXXXXXXXXXXXXXXXXXXXXXXXXXXXXXXXXXXXXXXXXXXXXXXXXXXXXXXXXXXXXXXXXXXXXXXXXXXXXXXXXXXXXXXX
