-----------------------------------------------------------------------------------------------------------------------------------------------------------------------------------------------------------
---------------------------------------------------------o-------------------------------------------------------------------------------------------------------------------------------------------------
---o----------------------o-----------------------o----------------------------o----------------------------------------------------------------o----------------------------oo--B-------------------------
-------------------------------------------------------------------------------------------------o----------------------------------o--------------X---------------------o---------------------------------
--------------------------------------------------------------------o-------o-----------B--------------------------------------o---------------------------------------------------------------------------
------------------------------------------------------X------------------------------------------------B--------------------------------------------------------X------------------------------------------
---------------------------o---------------------------------------------o-------------------------------o----------------------------------------------------------------------X------------------o-------
--------?----------------X-----------------------------------------------------------------------------XXXXXX-------B------------------------------------------------B---------?-----------------------v---
--------------------o-------------------------------------?-XXX-------------------------------------------o---------------------X----------------------------------------------------------------------f---
------------------------------------------------------X------X-----------------------??????------X-------------------------------o-----------B-------------o-----------------------------------o-------f---
---------------------------------------------------------------------o----------------------T----------------------------------------------------------------------------------------------------------f---
----------------------o-------XXX-XXX-------XXXX-X--------------XXXXX----------XXX---XXXXXX-|--------XXXXXXX---------BXXXXXBX-------o--------XXXXXBX---o------BBXB---o--------------------o------------f---
-----------------o--------------------------------------------------------------------------|-----------------------------------o----------------------------------------------------------------------f---
--------------------------------------------------------------X-----------------------------|---?--------------------------------------------------------o---------------------------------------------f---
m-E------------------------------------------------------------------------------------E----|----------E------o-----------------E--E------------E------------------------------------------------------X---
XXXXXXXXXXXXXXXXXXXXXXXXXXXXXXXXXXXXXXXXXXXXXXXXXXXXXXXXXXXXXXXXXXXXXXXXXXXXXXXXXXXXXXXXXXXXXXXXXXXXXXXXXXXXXXXXXXXXXXXXXXXXXXXXXXXXXXXXXXXXXXXXXXXXXXXXXXXXXXXXXXXXXXXXXXXXXXXXXXXXXXXXXXXXXXXXXXXXXXXXXXX
