-----------------------------------------------------------------------------------------------------------------------------------------------------------------------------------------------------------
-------------------------------------------------------------------------------------------------------------------------------------------------------------------X---------------------------------------
--------------------------------------------------------------------------------------------------------------------------------------------------o--------------------------------------------------------
---------------------------------------------------o------------------------X----------------------------o-------------------------------------------------------------------------------------------------
---------------------------------------------------------------------------------------------------------------X------------X---------------------------------------------o--------------------------------
--------------------o-------------------------BBBBBBB---------B------------------------o---X---------------------------------------------------o----o-------------------------------o----------------------
---------------------?---------------o----------------------------------------------------------------X-o-----------------------------------------------------X--------------------------------------------
--------------X------------------------X---o--BBBBBB-------------------------o-BBBXB---------------------------BBBBBBBB-------o----------o-----------?BBBBXX---X---o----------X-----------------X------v---
-------------------o--?--------------------o-----------------------?BBB---------------------------------------------------XXXX-X------------------------------------------o----------------------------f---
----------X-----o----o------------------------------T--------------------------o-----------------o----T------------------------------------------------------------B---------------------------o-------f---
----------------------------------------------------|----------------------X--------------------------|-----------X------------------------------------------o-----------------------------------------f---
-------------?B--------BXB-B-----------B------??--BB|B--------o------------BT?BBB----BB?BBBBB------oBB|BBBBBBBBXBX---BBB----BBB--XB?-X---BBBBB------XXXXXXXBBBBBBB----????X???---------------?---------f---
-----------------------------------------------o----T-----------------------|-----------------o-------|---------------------------------o------------------------------X--------X----------------------f---
-------------o-X------------------------------------|-o---------------------|---------------------o---|-------------------------------------------------------------------------------------?---o------f---
m-----------------------------------E---------------|-----------------------|-------------------------|---------------------------------------------E--------------------------E--E--------------------X---
XXXXXXXXXXXXXXXXXXXXXXXXXXXXXXXXXXXXXXXXXXXXXXXXXXXXXXXXXXXXXXXXXXXXXXXXXXXXXXXXXXXXXXXXXXXXXXXXXXXXXXXXXXXXXXXXXXXXXXXXXXXXXXXXXXXXXXXXXXXXXXXXXXXXXXXXXXXXXXXXXXXXXXXXXXXXXXXXXXXXXXXXXXXXXXXXXXXXXXXXXXX
