-----------------------------------------------------------------------------------------------------------------------------------------------------------------------------------------------------------
------X--------------------------------------------------------------------------------------------------B-----oo-----------------------------o------------------------------------------------------------
--------------------------------------------------------------------------------------------o------------------------------------------------------------------oo------------------------------------------
---------------------o----------------------X----------------------------------------------------------------------------------------X---------------------------------------------------------------------
-----B--------------------X-------------------------o--------------o---------------------------------------------------------XXXX--------------------------------------------------------------------X-----
---------------------------------X--------------------------------------------oX-o------B-----oo-----X---------o---------------------o---------------------------X----------------------o------------------
-----o---------------------------o------------------X--------oo---------------------------------------------------------------X---------o---------------------------------X---------B----------------------
--------------------------------?-X-----------?----------------------------------------o--o---------------------??------XXX?XXX------------------------------------o---X----------------o--------------v---
----------------------------------------?-----------------------B-------------------------------------o-----o-------------------------------Xo--------BXXXXX-X-----------------------------------------f---
---------X---------o------------------------o------o------------o------X--------XXX?-------------o--T-----o--------X----------------------------------o------------o-----------------------------------f---
-B------------------------------------------------------E----------------o---------------------?----|------o----------------------------------------T--------------------------------------------o-----f---
-----------XXX----XX-X-----X-----X--------XXXX--------XXX-T--------XXB------------------TXXXXXXXXXXX|XXXo-------XXXXXXXXX-XXX---------------------XX|XXX----X--------X---XXXXX?X----------------------of---
--------------------------------B-------------------------|-----------------------------|-----------|---------B------------o------------------------|----X-------------------X-------------------------f---
-o-----------------------------o--------------------------|-----------------------------|-----------|-----------------------------------------------|----------------------X---------------------------f---
m-E--------E---E------------------------------------------|-----------------------------|-----------|-----------------------------------------------|-----------------------------E--------------------X---
XXXXXXXXXXXXXXXXXXXXXXXXXXXXXXXXXXXXXXXXXXXXXXXXXXXXXXXXXXXXXXXXXXXXXXXXXXXXXXXXXXXXXXXXXXXXXXXXXXXXXXXXXXXXXXXXXXXXXXXXXXXXXXXXXXXXXXXXXXXXXXXXXXXXXXXXXXXXXXXXXXXXXXXXXXXXXXXXXXXXXXXXXXXXXXXXXXXXXXXXXXX
