-----------------------------------------------------------------------------------------------------------------------------------------------------------------------------------------------------------
-------------------o------------------------------------------X------------------------------------------------------------------------o-------------------------------------------------------------------
--------o-----------------X-------------o------------------------------------------------------------------------------------------------------------------------------------------------------------------
-----------------------------------------------------------------------------------------------------------X-----------------------------------------------------------------------------------------------
-----------X-----------------------------------------------------------------------------------------------------------------------------------------------------------------------------------------------
------------------------------------------------------------------------------------o----------------------------------------------------------------------------------------------------------------------
--o--------------o-----------------------------------------------------------------------------------------X-----------o-----------------------------------------------------------------------------------
----------------------------------------------------------------------------------------------------------------------------------X--------------------------------------------------------------------v---
---------X-----------------------------------------------------------XXXBXX------------------------------X?XXXXXXXXXXXXX--------B-XXXX-o---------------------------------------------------------------f---
----------------------------------------------------X-----------o----------T-----------------------------------------------------B--------------XXXXXX-------------------------------------------------f---
----------------------------------------------o---------------------------?|XXX----XXXXXX--------BBBB------------------------------------------XXXXXXXX------------------XXXXXX------------------------f---
----------------------T-----------------------------------X----------------|---BBB------------------------------XXXXXXXX------------------------o------------------------------------------------------f---
----------------------|--------------XXXXXX--------------------??XXXXXXX---|----------------------------------------------------------------------------------------------------------------B----------f---
----------------------|---------------------------XXXXX--------------------|-------------------------------------------------------------------XXXXX------------------------------------------B--------f---
m-E-------------------|---------------------------------------------E------|---------------------E------------------------------------------------------o----E-----------------------------------------X---
XXXXXXXXXXXXXXXXXXXXXXXXXXXXXXXXXXXXXXXXXXXXXXXXXXXXXXXXXXXXXXXXXXXXXXXXXXXXXXXXXXXXXXXXXXXXXXXXXXXXXXXXXXXXXXXXXXXXXXXXXXXXXXXXXXXXXXXXXXXXXXXXXXXXXXXXXXXXXXXXXXXXXXXXXXXXXXXXXXXXXXXXXXXXXXXXXXXXXXXXXXX
