-----------------------------------------------------------------------------------------------------------------------------------------------------------------------------------------------------------
---o-----------------------------------------------------X----------------------------------o-------------------------------------B------------------------------------------------------------------------
-------------------------------------------------o----o---------------------------------------------------------------------o---o?-----------o------o---------------------------------------o--------------
--o-------------------------------------------------------------------o------------o---o-----------------------------------------------X--X-------oo---------------X------------------------X--------------
----------------------------------------------o---------------------------------------------------B--------------------------------------------------------------------------------------------------------
------------B----------------------------------X-o-o----------------------B--------------------X-----------------------X?X?---------------------------X----X---------X-----------------------?-------------
--------X----------------------o-------------------------------o-?--------o--------------------------------------o---------------------------o-------------------------------------------------------------
-B-------B----------X----------X--------------BXB-------------------X---B-XBBBB------------X--------------Xo------BBB----------------------o------------------------------------o-------B--------------v---
----------------------------------------------------o-------o------o-------------------------------T--o---------------XXXX-----------------------?----T------------------------------------------------f---
------------------------------------------------------------------------------------o--------------|----------------------o----------------X------o---|------X---------------------X-------------------f---
---------------------X------------------------o-------------------------------------------------o--|-----------------------------------o--------------|------------------------------------------------f---
----------------o------X----BBBoBBX--o------BBBBB--BX-----------------BBX-BBXBX???-B?X?-----------B|BXBB-BBXX----?????X-------XBXBBBBBB------o----?X??|??-----------------------------o------------o---f---
-----------------------------------------T------------------o----o----------------------------Xo---|------------To------------------------------------|--------------?-----------B--B------------------f---
-----------------o---B----------------o--|---------------------------------B-----------------------|-----o------|-------------------------------------|-o----------o-----------------------------o-----f---
m-E--------------------------------------|---------------------------E-----------------------------|------------|-------------------------------------|-----------------E------------------------------X---
XXXXXXXXXXXXXXXXXXXXXXXXXXXXXXXXXXXXXXXXXXXXXXXXXXXXXXXXXXXXXXXXXXXXXXXXXXXXXXXXXXXXXXXXXXXXXXXXXXXXXXXXXXXXXXXXXXXXXXXXXXXXXXXXXXXXXXXXXXXXXXXXXXXXXXXXXXXXXXXXXXXXXXXXXXXXXXXXXXXXXXXXXXXXXXXXXXXXXXXXXXX
