-----------------------------------------------------------------------------------------------------------------------------------------------------------------------------------------------------------
-----------------------------------------------------------------------------------------------------o---------------------------------------------------------------o-------------------------------------
---------------------------------------------X---X-----------------------------------o---------------------------?-----------------------------------------------------------------------------------------
---------------------------?--------------------------o--o-o-------------------------BX------------------o--------------------------------------------o---------------------------o------------------------
----------------X---------oo-----------------------------o-----o-------------------------------------------------------------XXXX---------------o----------------------------------------------------------
-------?----------X-----------?-o-----------B------------------------X-----------------------X-----------o----------X-------X------------------------------------------------------------------------------
-o---X-o-------------------------------------------------------------o-----------------------------------------------------------------o----------------X-o-X-----------X-----------------------?-----?----
-----------------o----o--------------------B----------X------------------XXXXXXX-----------------------------------------XXXXXX--------------B------------------------------X--------------------------v---
-----------?----------------------X-------o-----------------------o-?-----------------XXXXX--------T---------------------------------------------X--------?------------------X-------------------------f---
---------------------------------------------------------B-----------------------------------------|--------------XXXXXX-------------------------------------------------------------------------------f---
---------------------------------------------------XXXXX--------------------------------------T----|----------o-----------------------------------------------X----------------------------------------f---
-----------XXX----XXXX--X--------X--o---------X-----XX------o-XXX----BBB-BBBBBBBB-----XX------|--XX|----------XXXXX?XXX---XXX----------o-----?-----------------B----XXXXXXXXX------------------o-------f---
------------------------------X--------------------------o----------X-------------------------|----|--------------------------------------------T----X----o----------------------?-------------?-------f---
------------------------------------------------------------------o------o-------X------------|----|--------------------------------------------|------------------o-----------------------------------f---
m-E--------E---E--------------------------------------------E---------------------------------|----|------------E----------------------o--------|-----------E------------------------------------------X---
XXXXXXXXXXXXXXXXXXXXXXXXXXXXXXXXXXXXXXXXXXXXXXXXXXXXXXXXXXXXXXXXXXXXXXXXXXXXXXXXXXXXXXXXXXXXXXXXXXXXXXXXXXXXXXXXXXXXXXXXXXXXXXXXXXXXXXXXXXXXXXXXXXXXXXXXXXXXXXXXXXXXXXXXXXXXXXXXXXXXXXXXXXXXXXXXXXXXXXXXXXX
