-----------------------------------------------------------------------------------------------------------------------------------------------------------------------------------------------------------
-----------------------------------------------?--------------------X---o-------------------------------------------------o--------o-----------------------------------------------------------------------
--------------------------------------------------------------------o----------------------------------X-B-----------------------?-----------------------------------------------o-------------------------
------------------------------------o----------------------------------------------o------------------------------------------------------------------------------------------X----------------------------
--------------Xo-----------o-------------------------------BBBB----------------------------------------------BBBB-------------------------------?-------o-----------------o--------X-----------------------
----------B--------------------------------------------------------------o-----------------------------------o--------------------------------------B------------------------------------------------------
----------------------X----------X-------------------------------------------------------------------------BBXBBB--------------------o------------------o---------------------X--------X-------------------
-----------------------------------------------------BBB----------------------------------------------------------------------------------------------------X------------------------------------------v---
--------------------------X-----------------------------BBBB---------------??????X---o---------T---o----?????-------------------BBBBB-BB--------BBB----------------------------------------------------f---
-----------------------------------------------------------------------------------------------|o------------------------------o------------------------------------ooBBB-----------o-o----------------f---
-------------------------------T---------------------o----------T--------------------------T---|------------T----------------------X-------------------------------------X----------o------------------f---
---------X---------------------|-------------T-------BBBBBBBX---|TBBBXBBXBBXBB-----BBBBB--?|??B|B-?????-???-|---o--------------XBB------------BXTBXXXXX-------T-----B-B--------------------------------f---
------------------------------T|-------------|------------------||------------o------------|---|------------|---T-------------------------------|-------------|------------o---------o------------B----f---
------------------------------||-------------|o----o------------||-------------------------|---|--X---------|---|-------------------------------|----o--------|--------------------o------------X------f---
m-----------------------------||-------------|------------------||-------E-----------------|---|------------|---|------E------------------------|--------E----|------------------------------------E--EX---
XXXXXXXXXXXXXXXXXXXXXXXXXXXXXXXXXXXXXXXXXXXXXXXXXXXXXXXXXXXXXXXXXXXXXXXXXXXXXXXXXXXXXXXXXXXXXXXXXXXXXXXXXXXXXXXXXXXXXXXXXXXXXXXXXXXXXXXXXXXXXXXXXXXXXXXXXXXXXXXXXXXXXXXXXXXXXXXXXXXXXXXXXXXXXXXXXXXXXXXXXXX
