--E--X--X--------E-------B|To---o-M-M-o-M------T--------?-----------B-M-E--M---M-?----o-T|--------------------Eo-----?------EB-BX---X-----MM-M-|--------------?-----|-?-----B--X-M---T---|-------?--X-|-
--?------E-B---B--------------BX--T--?-|-EX---X--EB---X----E-----o----BX--B---X---M----o----B-E-----E------E|----BEoB-o--------E----------?-B?M-----E----E-----o----M-|-E---MM----|-T---T-----------MXT-
---?----E------X---B------MM---M-T--------X-?----------------?-X--o-M---------o--X-------|-------------EE-----B------M------T-------------E---------|---T--E------oo---MB-MX--B------------E------------
-M----------X--|MB-------------E------?-o-?-------?----?----------------o---E------X--E----------X?--T---?E-T-----E-E--T--------?-E-----M---------|X-----E||XX----T---------------X------------------M--
----TM-----B-------T-----B---M-------------E-------E--------B?-----------------------?X?-----X---?---XX-E|-----o--o----B-----?-------M--M-?------?|---------------|--E-?E--B-EX--------T-?B---Xo--------
--T--------E-----o--X--oB------------T--TX-?-X---------EX-----o------X---B-----?--Mo------X--------M-------B-T---------------?-------E?--E---?-----MT-X------T------|------------?----X---TE-E?---------
-|-------o--|---------M-------MX-------E-------|-----T-o------X--B-----------ME--M-----------oE---------T----------E------?M-T--X------T---T---X-TE----E|---B?--o-----------X---|-o------|----B??-------
--?--------------------T---o--X-M--M--E-----T-----------?-o-------oE-o-B----o?-----T--|-E|---M---|-M?TE-----T---XM---E-B|--B-T-X-BT-M-----?XM---?--------------X?|--T--T---T--o----E-oX---------XXM----v
--oo-|-----?------M-----B---------------o|--EMXT--|------oX-------T--X----?XB--E----o--X--B-o---|--Xo-----?-BT----T--|---X---MBTo----X----M-M-X----B-----M?-M-|-------??--------------?--oB--BE-------?f
--B?o-----------M----B------ME---o---------M-----o|-------|-T|||------B-------M--?--------B-X---|----X--E--?-----BM----B-B-----B----X-XB-B----M---------------|o------M--M-?-?----------------MMEM-----f
----B-M-X-TM---M-------|B---M-?---T||?-------------E?--T----X-----?----M---T------oXM----------------oT?--?-B-B--X|--------------o-o-X---------TB----T-oE----?--E--o-----------E--E|---B-X--------T-T--f
--X--T-EX---E----------------T---TT---|-MB-----?-------TT-----M---------------??---|----E----BE-------|--B-E----------o-------------M?----Eo-----M-X-M------T-BE---M-------|----------------E---|-----Mf
---oB---|-M-T-X-------X---M-------------------?------X-T-B-------E--------o--XT--BE-M----|---T------o-B------------M---B-------------------|X-XoM-X--------X-------------M-M---E-M-------|o---X--T---X-f
------B---?---M-|------T------M---BB--------M--o-------o----oo---?----E-------M-M-------M-----?------?----o-|----------------X-|--X-M------|--?---X-B--T-------T-------?---?-M-----B-T--------o-------Tf
m------------------------------------------------------------------------------------------------------------------------------------------------------------------------------------------------------X
XXXXXXXXXXXXXXXXXXXXXXXXXXXXXXXXXXXXXXXXXXXXXXXXXXXXXXXXXXXXXXXXXXXXXXXXXXXXXXXXXXXXXXXXXXXXXXXXXXXXXXXXXXXXXXXXXXXXXXXXXXXXXXXXXXXXXXXXXXXXXXXXXXXXXXXXXXXXXXXXXXXXXXXXXXXXXXXXXXXXXXXXXXXXXXXXXXXXXXXX
