-----------------------------------------------------------------------------------------------------------------------------------------------------------------------------------------------------------
-------------X-----------o--o-----------------------------------------------------------------o--o-o----------------------------------------------------------------------------------------o--------------
--------o------------------------------o-------------------------------------------------------------------------o-----B----------------------o--?---------------------------------------------------------
-----------?---------------------------?o---------------------XXXXX--------------------------o--------------o----------------------------------------------------------------------------------------------
-------------------------------------o-------------------------------------------------------------------------------------------------------------o--------------------o----------------------------------
------------------------X---------------------------------------------------------------o------------------o-----X------------?------o----------------------------X------------------------?---------------
-----BX------------------------------------------------X---o------------------?-----X-----------X------------------?---------------------------------------------------------BX----------------------------
-X-----o-------------------------------------X--------------XXXXX------------o-X------------B--------XXXXB------o---------------------?----X----X-----------o---------o--------------------------------v---
------------------------------X-------------o--------------------XXX?X--------o-------------------------------------------------------o---------------o----------------???????X------------------------f---
-------------------?----------o--------------------o------------------B---------------X----------------------------------------------------X?X----------?---------------------------------X------X-----f---
---------------------------------------------o-------------------------o----------------E--------------X-------------X--------------------------o------------------------------------------------------f---
--X-X------------o------------------------------------T-----XX----------------XXXXXX-XXXX-----------XXXXXX----------XXXXX--o--XX-----------X------T------X------???????X-------------------------------f---
----------o-------------?---X-T-----------------------|------------------o---------------o---------------------o----------o---????--------------o-|----------------------o-------------X---------X-----f---
-------------o----------------|-----------------------|--------------B-----------------------------o--X------------------------------o------------|-----------------o----------------------------------f---
m-----------------------------|--------------------E--|-------------------------------------------------------------------------------------------|----------------E--------E--------------------------X---
XXXXXXXXXXXXXXXXXXXXXXXXXXXXXXXXXXXXXXXXXXXXXXXXXXXXXXXXXXXXXXXXXXXXXXXXXXXXXXXXXXXXXXXXXXXXXXXXXXXXXXXXXXXXXXXXXXXXXXXXXXXXXXXXXXXXXXXXXXXXXXXXXXXXXXXXXXXXXXXXXXXXXXXXXXXXXXXXXXXXXXXXXXXXXXXXXXXXXXXXXXX
