-----------------------------------------------------------------------------------------------------------------------------------------------------------------------------------------------------------
------------------------------------------------------------?----------------------------------o-----------------------------------------------------------------------------------------------------------
-------------------------------o--------------------------X------------------------------------------------------------------------------o------------------B------------o---------------------------------
--------------------------------------------------------------------------------------------------------X--------------------------------------------------------------------------------------------------
-------------?---o----------------------X--------------------------------------B----------------------------------B----------------------------------------------------------------------------------------
---------?--o--------------------------------------------------------------------------------------------------BBBB----X---------------------------------------------------o--o----------------o----X------
--------------------------?------------------------------------------------------------------B--------o--------------------------------------------------BBBB-----------------X----------------------------
--------------------------------?????--------------------BBBBBBBB------------------------------------------------------------------o----------------------o--------------------------------------------v---
-------------------------------o-o-----T------------------------------------BBB--?-----o---------X------------BXXBX--------------------------------BBBBBBBX--------------------------------------------f---
-----X-------------------------o-------|-------------------BBBBBB------------------------------------------BXB---------------------------------------------o---------BXBB-----------------------o------f---
---------------------------------------|------XX-------------------------------------------------------------------------------------?-----------T-----------------------------------------------------f---
-------------------------------BBBBBBXB|BBB-BB--BB?BBBBXBBBBBBBB-------XXXXB---------BBB--------BBB------???????---BX----------BBB-------T-BBB---|XBXBBB--------BBBBBBB--------------------------------f---
---------?-------------------------o---|--------------------------------------------------------------------------------------T----------|---o---|---T---o------------------o--------------------------f---
---------------------------------------|-------------------------------------------------------------o-------------------o----|----------|-------|---|----------X-X-------------B--o-----------?X--X---f---
m--------------------------------------|------------------------------------------------E-------------------------------------|----------|-------|---|---------E---E-------------------------------E--EX---
XXXXXXXXXXXXXXXXXXXXXXXXXXXXXXXXXXXXXXXXXXXXXXXXXXXXXXXXXXXXXXXXXXXXXXXXXXXXXXXXXXXXXXXXXXXXXXXXXXXXXXXXXXXXXXXXXXXXXXXXXXXXXXXXXXXXXXXXXXXXXXXXXXXXXXXXXXXXXXXXXXXXXXXXXXXXXXXXXXXXXXXXXXXXXXXXXXXXXXXXXXX
