-----------------------------------------------------------------------------------------------------------------------------------------------------------------------------------------------------------
---------------------X---------------------------------------------------------------------------------------------o--------------------------------------------------------o------------------------------
---------------------------------------------------------------------------------------------X-------------------------------------------------------------------------------------------------------------
-----------------------------------------------------------------------------------------------------------------------------------------------------------------------------------------------------------
------------------------------------------------X-----------------X---------------------------o----------------------?-------------------------X-----------------------------o-----------------------------
-----------------------------------o-------B----------------------------------------------------------------------------------------------------o----------------------o-----------------------------------
----------------------------------------------------------------------------------X------------------------------------------------------------------------------------------------------------------------
----------------------------------------------------------------------------------------------------------------------------------------o----------------------------------?---------------------------v---
-------------X-------------------------------------------------------------------------------------XXXXXXXX-------XXXXXXXX--X?XXXXX-------------------------------------XBXX--------------------------of---
-----------------------------------------------o-------------------------XXXXXX--------XXXXXXX----------------------------------------XX----XXXXXXXBBBB--------------------------o---------------------f---
--------?-------------------------------------------------------------------------------------------o----------------------------------------------------X------------BBBBB----------------------------f---
-----------------XXXX-------------------------------------------------------------------------------------------------------------------o-----o-----------------------------------------------o--------f---
------------------------------------------------XXXXXX-BBBBBBB--X-T--------------------XXXXXXBX---------------o------------------------o-----------------X----------------------o----------------------f---
----------------------------------------XXXXXX--------------------|---------------------------------------------------------------------------????-XX------------XXXXX---------------------o--------?--f---
m-------------------------------E---------------------------------|------------------------------------------------------------E-----------------------------------E-----------------------------------X---
XXXXXXXXXXXXXXXXXXXXXXXXXXXXXXXXXXXXXXXXXXXXXXXXXXXXXXXXXXXXXXXXXXXXXXXXXXXXXXXXXXXXXXXXXXXXXXXXXXXXXXXXXXXXXXXXXXXXXXXXXXXXXXXXXXXXXXXXXXXXXXXXXXXXXXXXXXXXXXXXXXXXXXXXXXXXXXXXXXXXXXXXXXXXXXXXXXXXXXXXXXX
