-----------------------------------------------------------------------------------------------------------------------------------------------------------------------------------------------------------
-----------------------------------------------------------------------------------------------------------------------------------------------------------------------------------?-----------------------
-------------------------------------------------------------------------------------------------------------------o---------------------------------------------------------------------------------------
-------------------------------------------------------------------------------------------------o---------------------------------------------------------------------------------------------------------
----------------------------------------------------------------------------------------------------------------------------?------------------------------------------------------------------------------
-----------------------------------------------------------------------------------------------------------------------------------------------------------------------------------------------------------
-------------------------------------------------------------------------------------X---------X-----------------------------------------------------------------------------------------------------------
-------------------------------------------------------------------------------XXXXXX------------------------------------------------------------------------------------------------------------------v---
-B---------------------------------------------------------------------------------------------------------------------T-------------------------------------------------------------------------------f---
---------------------------------------------------------------------????----------------------------------------------|-------------------------------------------------------------------------------f---
----------------------------------------------------------------------------------------------T------------------------|--------------------------o----------------------------------------------------f---
----------------------XXX-------------------------------------------XXXXXXX-XXXXXX----------XX|XXX----------XXXXX-XXXXX|X--------XXXXX--------------------???------------------------------------------f---
------------------------------------------------o---------------------------------------------|------------------------|-------------------------------------------------------------------------------f---
---------------------------------------------------o------------------------------------------|------------------------|------------------------------X------------------------------------------------f---
m-------E------------------------------------------------o------------------------------------|------------------------|--------------------------------------------------------------E----------------X---
XXXXXXXXXXXXXXXXXXXXXXXXXXXXXXXXXXXXXXXXXXXXXXXXXXXXXXXXXXXXXXXXXXXXXXXXXXXXXXXXXXXXXXXXXXXXXXXXXXXXXXXXXXXXXXXXXXXXXXXXXXXXXXXXXXXXXXXXXXXXXXXXXXXXXXXXXXXXXXXXXXXXXXXXXXXXXXXXXXXXXXXXXXXXXXXXXXXXXXXXXXX
