-----------------------------------------------------------------------------------------------------------------------------------------------------------------------------------------------------------
----------------------------------------------------------------------------------------------------------------------------?------------------------------------------------------------------------------
-------------------------------------------------o----------------------------------------------------------------------------o---------------?--------------------------------o---------------------------
-----------------------------------------------------------------------------------------------------o-----------------------------------------------------------------------------------------------------
-------------------------------------?------------------------------------------------------------------------------------------------------------------------------------o--------------------------------
------o----------------------------------------------------------------------------------------------o---------------------------------------------B-------------------------------------------------------
---------------------------------------------------o-------------------------------------------------------------------------------------------------------------------------------------------------------
------------------------------------------------------------o---------------------X--------------------------------------------------------------------------------------------------------------------v---
-------------------------------------XXX------------------XXXXXX----------XXXXXX--------------B--------XXXX--------------------------------------------------------------------------------------------f---
-------------------------------------------------XX?X-X--------------------------------------------------------XXXXXXXX----------------------------B---------------------------------------------------f---
----------------------XXXX-------------------BBBBBXXXXXX-----------------------------------------------------------------------------------------------------------------------------------------------f---
-------------o-------o--XX---------------XXX------------------------------X--------------o-----------T------------------------------------XXXXXX-------------------------------------------------------f---
-------------------------------------------------------------------------XXXXXX-------------o--------|--------------o--T-------------------XXXXXXX-----------XXXXXXXX----------------------------------f---
------------------------------BBBBXB----------------------------o------------------------------------|-----------------|------------o------o-----------------------------------------------------------f---
m-E----------------------------o----------E-----------------------------------------E----------------|-----------------|-----------------------E-------------------------------------------------------X---
XXXXXXXXXXXXXXXXXXXXXXXXXXXXXXXXXXXXXXXXXXXXXXXXXXXXXXXXXXXXXXXXXXXXXXXXXXXXXXXXXXXXXXXXXXXXXXXXXXXXXXXXXXXXXXXXXXXXXXXXXXXXXXXXXXXXXXXXXXXXXXXXXXXXXXXXXXXXXXXXXXXXXXXXXXXXXXXXXXXXXXXXXXXXXXXXXXXXXXXXXXX

