-----------------------------------------------------------------------------------------------------------------------------------------------------------------------------------------------------------
----------------------------------------------------o--------------o------o--o-o-----------------------------------------------------------------------------------------o-----------o---------------------
------------------------------------o---------------------------------------------o-----------------------------------------------o---------o---------------?---o------------------------------------------
--------------------------------------?---------------------------o--------------------------------------------X-------------------X--o--------------------------------------------------------------------
---------------------------------------o--------X----------------------------------------------------------------------------------------------------------------------------------------------------------
------------B------?----------------------------------B-------------B----------------------X--------------------------------------------o-------------------------------------X---------o------------------
-----------------------------X--------------XB-----------------------------------------------------------o------------------------------------------o---------X--------X-----------------------------------
--------o---------B------------------------------------------o----o------?-----------------X------------------o---------------------------X-----------------------------------------B------------------v---
---------------------------?---------------------------------------------X------X--------o-----------------B-------o-----------T-------------------------------------------X---------------------------f---
--------------------X-----------------------------X---------X---------o-------------------------T-----------------------------o|o--X----------------------------?--------o-----------------------------f---
------------------------------------------------------------------------------------------------|-----------------X------------|-----------------------------X--------X--------------X----o------------f---
------------B--X---------T------------------------------?T--------------------------------oT----|---------o--X---------------T-|------o---------------------------------?----------------B-------------f---
-------------------------|----------T--------------------|---------------T-----------------|----|-----------------------T----|-|-------------------------------T-o-------------X-----------o-----------f---
-------------------------|----------|--------------------|-o----------X--|-------------B---|----|-----------------------|----|-|---------------------o---------|---------?----B------------------------f---
m-o----E-----------------|----------|--------------------|---------------|---------E-------|----|---------------E-------|----|-|--------------------------o----|---------------------------E-----------X---
XXXXXXXXXXXXXXXXXXXXXXXXXXXXXXXXXXXXXXXXXXXXXXXXXXXXXXXXXXXXXXXXXXXXXXXXXXXXXXXXXXXXXXXXXXXXXXXXXXXXXXXXXXXXXXXXXXXXXXXXXXXXXXXXXXXXXXXXXXXXXXXXXXXXXXXXXXXXXXXXXXXXXXXXXXXXXXXXXXXXXXXXXXXXXXXXXXXXXXXXXXX
