-----------------------------------------------------------------------------------------------------------------------------------------------------------------------------------------------------------
--------------o--------------------------------X-----------------------------o-----------------------------o------------o-----o----------------------------------------------------------------------------
--------o---------------------------------------------------------------X----------------B---------------------------------------------------------------------------------------------------o-------------
-------------------o-------------------------------------------------------X--------------------------------------------------------------o----------------------------------------------------------------
---------------------------------X----------------o--------X----o--------?o---------o-----------------------o---------------X---------------------------X---------------------------------------o----------
--------------X----------X--------------------------------------------X------------B-----B------------------------------------------------B-----?---------o----o-------------------------------------------
----------------------------------------------------o---o-------------------------o-------------------------------------------------------------------------------------B------X---------------------------
-------X---------o-----------------------------------o--------X----------------X------?-----------o----o---------------------o----------------------------------------------o--------------------------v---
---------?------------------------------o--o----------------------------------?-????-------XXX------------XXXX--------------X---------------------------X--XXBXXXXB------------------------------------f---
----------------X--BBBBB----------------B-?------------------o----------------------------------------------------------------------------------?XXXX--------------------------------------?-----------f---
----------------?---------------o--------------------------------------------------------------------BBB----------------------------------------o------------------------------------------------------f---
--o---------o-----X----B--------------------------------------------------------------o-------BXBBBBB-----------XXXXXXXXX-------------XXXXXXXX-------------XXXX---------------------?------------------f---
----------------------X----------B--------------T-------------------------X---------------------------------------------X--------------------------------X-------------o------------o--------------o---f---
------------------------XXX--------XXXXX-Xo-----|------o--------------------------------------------X--------------------------X---o------------------------o------------------------------------------f---
m---------------------------------------E-------|--------------------------------------------------------E---------------------------E---E--------E----------------------------------------------------X---
XXXXXXXXXXXXXXXXXXXXXXXXXXXXXXXXXXXXXXXXXXXXXXXXXXXXXXXXXXXXXXXXXXXXXXXXXXXXXXXXXXXXXXXXXXXXXXXXXXXXXXXXXXXXXXXXXXXXXXXXXXXXXXXXXXXXXXXXXXXXXXXXXXXXXXXXXXXXXXXXXXXXXXXXXXXXXXXXXXXXXXXXXXXXXXXXXXXXXXXXXXX
