-----------------------------------------------------------------------------------------------------------------------------------------------------------------------------------------------------------
-----------------------------------------------------------------------------------X------------------------------------------------------------o-----------------------------------o---------------o------
------------------------------------------------------------o---------o------------------------------------------------------------------------------------------------------------------------------------
-----------------------------------------------------------------------------------------------------------------------------------------------------------------------------------------------------------
-------------------------------------------------X---------------------------------------------------------------------------------------------------------------------------------------------------------
-----------------------------------------------------------------------------------------------------------------------------------------------------------------------------------------------------------
-----------------------------------------------------------------------------------------------------------------------------------------------------------------------------------------------------------
-------------------------------------------------------------------------------------------------------------------------------------------------------------------------------------------------------v---
-------------------------------------------------------------------------------------------------?????---------------------------B----------------------------X----------------------------------------f---
---------------------------------------------------------------------------------------------------------------------------X---------XXX---------------------------------------------------------------f---
-------------------------------------------------------------------------------------------------------------------------------------------------------------------------o-----------------------------f---
-----------------------------XXXX--XXXXXXX-------XXXXXXX------------XXX------XXXXXXXX---------XXXXXXX----------XXX-XXXXXXXX--XXXXXXXXXX-XXXXX---------T----T-------------------------------------------f---
------------------------------------------------------o---------------------------------------------------o-------------------------------------------|----|-------------------------------------------f---
----------------------------------------------------------------------------------------------------------------------------------------------------o-|----|-------------------------------------------f---
m-------------E-------------------------------E------------------------E-----------------------------------------o------------------------------E-----|----|---------------------------E---------------X---
XXXXXXXXXXXXXXXXXXXXXXXXXXXXXXXXXXXXXXXXXXXXXXXXXXXXXXXXXXXXXXXXXXXXXXXXXXXXXXXXXXXXXXXXXXXXXXXXXXXXXXXXXXXXXXXXXXXXXXXXXXXXXXXXXXXXXXXXXXXXXXXXXXXXXXXXXXXXXXXXXXXXXXXXXXXXXXXXXXXXXXXXXXXXXXXXXXXXXXXXXXX
