-----------------------------------------------------------------------------------------------------------------------------------------------------------------------------------------------------------
------------------o----------------------------------------------------------------------------------------------------------------------------------------------------------------------------------------
---------------------------------o-------------------------------------------------------------------------------------------------------------------------------------------------------------------------
-----------------------------o-----X---------------------------------------------------------------------------------------------------------o------------------------------------------o------------------
-----------------------------------------------------------------o-----------------------------------o-----------------------------------------------------------------------------------------------------
------------------------------------------------------------------o---------------o----------------------------------o-------------o----------o------------------------------------------------------------
--------------------------------------------------------------------------------------------------------------------X--------------------------------?-----------------------------------------------------
------------------------------------------------X------------------------o-----------------------------------------------------------------------------------------------------------------------------v---
--------------------------------XX-X-----o-----------------------------------------------------------XXXXX----------------o-----------------------------XXXXXXX----------------------------------------f---
---------------------------o-----------------X-----------BXXXX-------------------o-------------------------------------------o-------o---XXXXXXX-------------XXXXX-------------------------------------f---
-----------------------------------------------------------------XXXXXXX--------------------------------------------XXXXX------------------------------------------------------------------------------f---
-------------------?XXXXX-----------------------------XXX--------------------------------------------------------???------------------------------------------------------------------o----------------f---
------------------------XXXX-----------XXXX?X---------------------------o-----------------------------------------------------------o-----o--------------------------------------o---------------------f---
-----------------------XXXXXXXX-------------------------------------------------------XXX------------------------------------?XXXXXXXX-----------------------------X-----------o-----------------------f---
m--------------------E-----------------------------------------------E----------------------------------------------------------------------------------E----------------------------------------------X---
XXXXXXXXXXXXXXXXXXXXXXXXXXXXXXXXXXXXXXXXXXXXXXXXXXXXXXXXXXXXXXXXXXXXXXXXXXXXXXXXXXXXXXXXXXXXXXXXXXXXXXXXXXXXXXXXXXXXXXXXXXXXXXXXXXXXXXXXXXXXXXXXXXXXXXXXXXXXXXXXXXXXXXXXXXXXXXXXXXXXXXXXXXXXXXXXXXXXXXXXXXX
