-----------------------------------------------------------------------------------------------------------------------------------------------------------------------------------------------------------
------------------------------------------------------------------------------------------------------------o-------o--------------------------------------------------------------o-----------------------
-----------------------------------------------------------------------------------------------------------------------------------------------------------------------------------------------------------
------------------------------------------------------------------------------------------------------B----------------------------------------------------------------------------------------------------
-----------------------------------------------------------------------------------------------------------------------------------------------------------------------------------------------------------
--------------------------X-----------------------------------------------------------X--------------------------------------------------------------------------------------------------------------------
-----------------------------------------------------------------------------------------------------------------X------------X----------------------------------------------------------------------------
-------------------------------------------------------------------------------------------------------------------------------------------------------------------------------------------------------v---
---------------------------------------------------------------------------------------------------XXXXXXXX-----------------XXXXXXX-------------o------------------------------X-----------------------f---
----------------------------X------------------o----------o-?------------XXXXXX--------XXXBXXX---------------------------------------------------------------------------------------o-----------------f---
------------------------------------------------------------------------------------------------------------------------B----------------------XXX???T????---------------------------------------------f---
-----------------XXXX----------------------------------------------------------------------------------------o---------------------------------------|------------o------------------------------------f---
-----------------------------------------------XXXXXXX-BBBBBXB----T--------------------XXXXXXXX------------------------------------------o------E----|-XXXXXXXX----------------------------------------f---
----------------------------------------XXXXXX--------------------|---------------------------------------------------------------------XXXXBX-XXX---|-------------XXXXXXX-----------------------------f---
m-------------------------------E---------------------------------|------------------------------------------------------------E----------E----------|-----E-----E-------------------------------------X---
XXXXXXXXXXXXXXXXXXXXXXXXXXXXXXXXXXXXXXXXXXXXXXXXXXXXXXXXXXXXXXXXXXXXXXXXXXXXXXXXXXXXXXXXXXXXXXXXXXXXXXXXXXXXXXXXXXXXXXXXXXXXXXXXXXXXXXXXXXXXXXXXXXXXXXXXXXXXXXXXXXXXXXXXXXXXXXXXXXXXXXXXXXXXXXXXXXXXXXXXXXX
