-----------------------------------------------------------------------------------------------------------------------------------------------------------------------------------------------------------
-------------------o---------------------------------------------------------------------------------------------------------------------------------------------------------------------------------------
--------------------o--------------------------------------------------------------------------------------------------------------------------------------------------------------------------------o-----
-------------o---------------------------------o-----------------------------------------------------------------------------------------------------------------------------------------------------------
-----o----------------------------------X-------------------o--------o------X----------------------------------------E---------------------------------------------------X---------------------------------
-----------------------------------------------------------------------------------------------------------BB--BBXBBBBX-------o-------------o--------------------------------------------------------------
------------------------------------------------------------------------------o------------------------------------X-----------------------------------------------X---------------------------------------
---o-----------X-----------------------------------?----------------------------------------------------------------------------B?BBXB-----------------------------------------------------------------v---
---------------o--------------------o--------------------------------------------------------------------------------o-----------------------------------------------------------------o---------------f---
-------------------------------------------------------------------------------------------------------BBB-BBBXB------o-------------------------------XXXXX-------o-----?BBB--------o------------------f---
-----------?----------------------oT---o--------------------o------T------T----------------------------------------------------------------------------------------------------------------------------f---
-----------------X--------BBB---BBB|-BB---BBB---------------XXXXXXX|---??T|-XBXXX----BBBBBBBB--------???????-----BBB--BBB-----BBBBBXBX---------------------------BBB--BBBBBB--------------------------of---
-----------------------------------|-----o-------------T-----------|-----||---------------T--------------------------------------------------------------------------------------------o---------------f---
-----------------o-----------------|-------------------|-------o---|-----||o--------------|------------------------------------------------------------------------------------------------------------f---
m---E-------E---------------------E|--------E----------|-----------|-----||---------------|-------------------------------------E------------------------------------E---------------------------------X---
XXXXXXXXXXXXXXXXXXXXXXXXXXXXXXXXXXXXXXXXXXXXXXXXXXXXXXXXXXXXXXXXXXXXXXXXXXXXXXXXXXXXXXXXXXXXXXXXXXXXXXXXXXXXXXXXXXXXXXXXXXXXXXXXXXXXXXXXXXXXXXXXXXXXXXXXXXXXXXXXXXXXXXXXXXXXXXXXXXXXXXXXXXXXXXXXXXXXXXXXXXX
