-----------------------------------------------------------------------------------------------------------------------------------------------------------------------------------------------------------
---------------------------------------------------------------------------------------------------------------------------------------------------------------------------o-------------------------------
-----------------------------------------------------------------------------------------------X-----------------------------------------------------------------------------------------------------------
---------------------------------------------------------B-------------------------------------------------------------------------------------------------------------------------------------------------
-----------------------------------------------------------------------------------------------------------------------------------------------------------------------------------------------------------
-----------------------------------------------------------------------------------------------------o-----------------------------------------------------------------------------------------------------
------------------------------------------------------------------------------o----------------------------------------------------------------------------------------------------------------------------
--------------------------------------------------------------------------------------------------------------------------------------XXXXXXX-------------------------------------------------------X--v---
------------------------------XXXXXX--------------------------------------------------o----------------------------------------------------------------------------------------------------------------f---
--------------------------------------------------------------o-----------------------------------------------------------------XXXXXXXX---------------------------------------------------------------f---
-------------------------------------------------------------------------------------------------------------o------------------------T-----X----------------------------------------------------------f---
-----------XXXXXXX--------------XXXX-------------------T----XXXXXX--XXXXXXX-----------------------------?XXXXXXX----------------XXXX--|---------------XXXX-----------XXXX------------------------------f---
-------------------------------------------------------|------------------------------------------------------------------------------|----------o-----------------------------------------------------f---
-------------------------------------------------------|--------------------------------o---------------------------------------------|----------------o-----------------------------------------------f---
m------------------------------------------------------|-----E-------------------------------------------------------------E----------|---------------------------------------------------------------oX---
XXXXXXXXXXXXXXXXXXXXXXXXXXXXXXXXXXXXXXXXXXXXXXXXXXXXXXXXXXXXXXXXXXXXXXXXXXXXXXXXXXXXXXXXXXXXXXXXXXXXXXXXXXXXXXXXXXXXXXXXXXXXXXXXXXXXXXXXXXXXXXXXXXXXXXXXXXXXXXXXXXXXXXXXXXXXXXXXXXXXXXXXXXXXXXXXXXXXXXXXXXX
