-----------------------------------------------------------------------------------------------------------------------------------------------------------------------------------------------------------
-------------------------------------o----B---------------------o------------------------------o-----------------------------------------------------------------------------------------X-----------------
-o----------------------------o----------o-o---------------------o---------X------o--------------------------------------------------o-----------------------------o-------------------------o-------------
----------------------------------------o---------------------------------------------o-------------------o--------?-------------X---------o---------------------------------------------X-----------------
------------X-------------X----------X--o-----------------------------------------------o----BXX--o-----------------------------------?-----------------X--------o-----------------------------------------
-o--------------------------------o-X--------------------o-----------------------------X-----------------X------------------?----------------o---?---------------B---o-----o-------------------------X-----
---------------X---------------------------B-----------------?---------------------------------------------------------------X-------o-----------------o----o---------------?----------------?--o----------
-----------------------------------------------------------o---------------------------BXBBBX-B-------o--------????-B---------------------------------X---oX-o-------------X---------------------------v---
---B-----------o-?--------B--------------------------------------------o--BBBB-BB---------------------o---?------------------------------------------------?-T---------------------------X-------------f---
--------------------o----o----------T----------oo-------------------------------------------------------------------------------T----------------------------|---------------X-------------------------f---
------------------------------------|-------------------o--X------------------------o-------------------------------------------|--------------------------o-|--------------------------------o--------f---
----X------------------------------B|B------------XXXX----------BBT-o----Bo----------XXXXX-o-----BX---XBBTBB---BXBBBBBB-----X--B|B---BB-BB-----T--------o---B|B---------------------o---X------o-------f---
-----------------------------------o|--T--------------------T-----|------------------------o-------------|--------o-------------|--------------|-------------|-----------------------------------------f---
----o-------------------------------|--|-----o--------------|-----|-----------B---------------o------o---|----------------------|--------------|-------------|-o----------------------------X----------f---
m-----------------------------------|--|--------E-----------|-----|--o---------------E-------------------|----------------------|--------------|-------------|--E--------------------------------------X---
XXXXXXXXXXXXXXXXXXXXXXXXXXXXXXXXXXXXXXXXXXXXXXXXXXXXXXXXXXXXXXXXXXXXXXXXXXXXXXXXXXXXXXXXXXXXXXXXXXXXXXXXXXXXXXXXXXXXXXXXXXXXXXXXXXXXXXXXXXXXXXXXXXXXXXXXXXXXXXXXXXXXXXXXXXXXXXXXXXXXXXXXXXXXXXXXXXXXXXXXXXX
