-------X----|MM--Mo-T--------o--E--|---------B------------------|---?---------?-M---T--T--E-------------M---?----B-|----M---------TX------?-------B--|||--|B-----TM---|-o--E------o------------o?--E----
----B---o-T----------|------?---------o-----|T--M-------------------B----E---E--------B-B-X-B--B-o--M-||MX?-T--E---|---?|TE---E-------To---MT----M|-X-----?---M-----|T|----o----------B--------oB--X--E-
-----B-------------o-o----------M----?---?X--?-?-X-X-------||-------|---|------X--B|?----E-E-----|--------|--|--|E---------|X-o------?-M-----?-M?----ET--T--o---T--EE-----|------B-B-M-------B-M-o-|----
-E-----E-XE?-------E---o---E---E?----o---------|----o--T-------B------E-E--o---M-----M---T-M------M-X-----o-----------------M-B-----T--B-----X-------X----------------X-------o--o--M-o---Xo------TT----
--|------------------|-----|TE---ME--|-??--M---o-?---M-BT---------|--|--------|-------M-?----TBBM---BE--|--oT--------o---T-----X---X--------T---|---E---E---M-E------------B-----X--Eo-M|--T------------
---|X----E--B---TT--X--------------Xo--o--|-?X-oT--------ET-E--BE-B--|----X--------X-XT-M?-E-M---E---T-----X-E----||----X-|------oE--B----Mo-----o-T-TME-E-----XBo--B-B-T--?------M--------------T---|o-
----o-o------o--------X---T---------M--X--------B-----?-----X----|----T--M-X---------------|----?-X--ME--B---X|---?-ooB--|--------|-?-M---?-----|---B--E-----T-----o---------X-oX----?-o-----?-o------o-
----?-----M---T--|----B----M----E-o-----M--o----------o--T--T--M---o-------B------B----?--T----B--|---------B-------?--X----X----EE----T----B-------X-TM--E--M--M-----EX-B-?--------Mo----M-M----------v
--B--B-------M-------------?---|------------T------X--M----M--------|-M------|T-XM----o-------B--E-----------|--T-----E|---T--o---X?o--o-M-------o----B---M-----X--E---?---------o-B--M---M---|X-------f
--E-----------|--------E?--?-----EM-------------E----?--EEo----X-T-X----M-E---?------------X----?-----o---|TXE---T-----TX-----E-B-?------------|----E---X---------E-----X||--?-X-E--------T--T-oXM--EM-f
---E-M------?--|--o----X---------X---X-X-|-------MBX----------------M-------T---?---------?---B--------?o---XT-------------|M----M-------o|B-----oXMB----?------T----X-X-----M---o--T?----X-----B-E---Mf
---M---o---|?-|-------|E--MT--X-o----M--?---E-o-------?----?-------XME--o-B-----M----o----|--------T-----o-------|X-o-----E------B|o----M----o--------X-----B-----------X------T?------?--B-?----------f
----B---------------M------T----?--------?-X------XT-----------|--T-?------E-----E?--------B--E--------?----T-----|-?---T?E?--B--E-----M--------------|------B-M-E---X---------o?-X-----E|----T-|X-MBE-f
-B----------------X|----|------------|--------E-------E------------X--X--T--o---------oo-B----T---------?-?-M--?---TT----|---M---Boo--ET----X--B---B---M----------o--M-------o-M-----------E--|--B-----f
m---E|--E-|---------X-------|--X----E--T---E-o-----B-----------------M---------o-T--E-o----|B----E|----T-------?-----T--B--o--------|-M--T----To----|X-M----X----MoEoT------B----T--?--Eoo----M---T---|X
XXXXXXXXXXXXXXXXXXXXXXXXXXXXXXXXXXXXXXXXXXXXXXXXXXXXXXXXXXXXXXXXXXXXXXXXXXXXXXXXXXXXXXXXXXXXXXXXXXXXXXXXXXXXXXXXXXXXXXXXXXXXXXXXXXXXXXXXXXXXXXXXXXXXXXXXXXXXXXXXXXXXXXXXXXXXXXXXXXXXXXXXXXXXXXXXXXXXXXXX
