-----------------------------------------------------------------------------------------------------------------------------------------------------------------------------------------------------------------
--------------------------------------------o-----------------------------------------------------------------------------------X-----------------------o--------------------------------o-----------------------
-------------------------------o----------------------------------X----------o-------------------------------o-------B----------------------------o---------------------------------X----------------------------
-------------------o------------------------------------------o----o---------------------------------?----------------------------------------------X--------------------------------o----------o----------------
---------------------------------o-------------------------------------------------------------------------------------------------------------------------------------------------------------------------------
--------------------------------------?------------------XBB-BB-------------------------o----------------------BB-B-------------------------o----------------------------------------X---------------------------
------------------------------------------------------------------------X-------------------------------o------------------------------------B-o--------X---------------------X----------------------------------
--------------------B-----------??-??---------------o---BBB-B---------???------------BBBBBBB------------------o-----------------BBXBBB----?----X-BBB--------------------X-----------------------B----o-v---------
---o-------------------X-o-------o-----T-o----------T---------------------oo-----------------o-T--------------BBBB?-----T--X----------------o---o------------------------------------------------------f---------
----------------------o----------------|------------|---------o-----------------------T--------|-------o---BBB----------|-----------------------------------------o------------------------------------f---------
-----------------o---------------------|------------|-----------------------T-------o-|--------|------------------------|------------------------------------------------------------------------------f---------
-------------------------------BBBoBB-B|BBBBBB--BBBB|BB--------TT??BBB?B-BB-|-----B-XB|B----B?X|B-X?X??--???????---B?BBB|BB-BXBBB?B---BBB------BB??BBBB--o----?-????-----------------------------------f---------
------------------------------o--o-o---|------------|----------||-----------|---------|-T------|---------?--------------|-o-------------------------------o--------------------------------------------f---------
---------------------------------------|------------|----------||-----------|-------X-|-|------|------------B-----------|----------------------------------o-----------------------------------------o-f---------
m-------E------------------------------|------------|----------||----E----E-|---------|-|------|------------------------|--------------E-------------E--------------------------------E------------E---X---------
XXXXXXXXXXXXXXXXXXXXXXXXXXXXXXXXXXXXXXXXXXXXXXXXXXXXXXXXXXXXXXXXXXXXXXXXXXXXXXXXXXXXXXXXXXXXXXXXXXXXXXXXXXXXXXXXXXXXXXXXXXXXXXXXXXXXXXXXXXXXXXXXXXXXXXXXXXXXXXXXXXXXXXXXXXXXXXXXXXXXXXXXXXXXXXXXXXXXXXXXXXXXXXXXX
