--E--?-|X-----M------------Xo-E--?T-Bo-------X---XM---T-?----T-----------|-------|--------o-B|-To---T--?oE------|T----|o|o-----|-M---BX---?E---E---T--BT---T-X-B--B----------------X-?----T-X----B--TEB-
-----------|--------oM--------M-M----o-?M|M?-o--------------------M-B-----------oX--------|-T--B----?---M--?-o-|----|--------T---T-----------E--o-|-o-M--E-------M-------o---------------B-B-------To---
--E-E--B---|-B----B-----------|-|M-B----B----B-B-----o-B------E--B------MX-------T---X--E------X-o-----M|---T----X-----------------X----B------?-ME--E-E-----T--X----MM--X-----B?---M--X------|B?E------
-----X-------T--?--ME-----|--TE---XB------XM---?---E-----------Eo--B-?--E---------B-----X-T-T--------E--M|----X--------------|?T-MM--------M-----T-----|B--T---M-----X-B------|---------E---B-?--|--oM--
----?--B?--E---?X--T------ME---------|T-M-|--T-----M-------|---------|---M------XT--B-X-M-M---------E--E-------M-X-----------B-o----o-o------E----------MX-------B?---------T---B--------o-----o--oo----
---------E----------EE------E------B-o---------?----B-M-B---X---T--------?------X-?-T---?----Xo-----?--MTE--B-----X---o-----T?-E-?------|---|-X--------|T------------------------B---|---M-----?-|--o---
----MB--|-------E------------X-oT--o?-----Bo-T---X-EXM--?----MB---E----EBMX------|----------|-----X--?-------X--?---X---T-T-------E--B--Eo-------T------E--BT----------|--?--X-oo-----B-----------E--|--
-XT-B--M-X-----X---E--------o------|-E--Bo--T---|--o-B-B----B--M------ToE-----------?E-T---E--B--o---T--X--M-------?--o----B?-|TB--?-----E-o--?Mo-o-?----X-------T-|--To---X-|-B-----?----|--B-----B---v
---X-------T----|?o------E---?-M---T?----------------------------E-o----?|--|--------X-o---XX--------------M----------To--------M-------|-MB-----|MBM-BBM---E------E?----MX--------TM--B-T---------E--|f
--E?----EM-----------T-M----TB-----E-E--------Bo-E-T----|B-----o-E----|--?-?-E-----------------------------------------E---?--B--EM|-T---|--T---------XE-M---------X----------E----------B-X--M----|B--f
----o--M---T-------T--T---X----?--------|---M|----o---|--B---E------E-X--B-------------------?-||------E----Eo---E--B-oo----T---B----?-|--BE--EX-------?oB------X|----------ET------?---X-EE-------E---f
-B---------------T---------E----E-B-----oo---o-M--E--|---X--B-----?----X---o------------?--M-------EE---------X-|-----Bo----X--|---|----ooT-----T--?-----?--------M------B---M--E----E-BMM--o-T---B----f
-o-----o?--M--------B----B---o--------o-------M--B--o-------?---B-|----E------o|-?----TXT-------T------EX-----E----B-------o------|?-o-E---E-|----o--o-o-|-----|-T---------BE-------|-----------||---E-f
---------------o-T---o-B----------E-----M--B---B-X--E----------------------|--o---------B--B--B--?--------B--E---?--B--X----ET---?X--M-----o----------X-------------B--------M--X--B---?-T-M----M-?--X-f
m------------------------------------------------------------------------------------------------------------------------------------------------------------------------------------------------------X
XXXXXXXXXXXXXXXXXXXXXXXXXXXXXXXXXXXXXXXXXXXXXXXXXXXXXXXXXXXXXXXXXXXXXXXXXXXXXXXXXXXXXXXXXXXXXXXXXXXXXXXXXXXXXXXXXXXXXXXXXXXXXXXXXXXXXXXXXXXXXXXXXXXXXXXXXXXXXXXXXXXXXXXXXXXXXXXXXXXXXXXXXXXXXXXXXXXXXXXX
