-----------------------------------------------------------------------------------------------------------------------------------------------------------------------------------------------------------
---------------------------------------------------------------------------------------------------------------o-------------------------------------------------------------------------------------------
-------------------------------------------o----------------o-----------------------------B---------X---------------------------------------------X--------------------------------------------------------
----------------------------------------B----------------------------------------------------------------------------------------------X-------------------------------------------------------------------
-----------------------------------------------------------------------------------------------------o----------------------------o----------------------------------o-------------------------------------
--------------------------------------------o-------------------------?---------------------------------------------------------------------?----------------B------------------------------o--------------
----------------------------------------------------------------------------X------------------------------------------------------------------------------------------------------------------------------
----------------------------------------------------------o-----------------------------------X--------------------------------------------------------------------------------------------------------v---
-------------------------------------------------XXXXXX---T---------XXXX-----o-------------------------------------------------------------XXX-------------------?-------------------------------------f---
-----------------o----------------------------------------|-----------X---XXX---------T--------------------------------o----------------------------------------------------------------oo-------------f---
----------------------------------------------------------|---------------o-----------|o----------XXX------XXX-------------------XXXXX--------------??-???--------------------------------o------------f---
-----------------X----XXXX-----------------------------o--|-----------------BBB--XXX--|------X-----------------------------XXX?--------------------------o------T------------X-------------------------f---
-------------------------------------------XXXXXX---------|----------------------XX?XX|X---------------------T--------------------------------------------------|--------------------------------------f---
--------o--------------------------o--XXXX--------------X-|-------XXXXXX--------------|-BBBBB-----X----------|------BBB-XXXX------------------------------------|--------------------------------------f---
m-----------------------------------------o---------------|--E------------------------|----------------------|----------------------------------------------E-E-|-------E------------------------------X---
XXXXXXXXXXXXXXXXXXXXXXXXXXXXXXXXXXXXXXXXXXXXXXXXXXXXXXXXXXXXXXXXXXXXXXXXXXXXXXXXXXXXXXXXXXXXXXXXXXXXXXXXXXXXXXXXXXXXXXXXXXXXXXXXXXXXXXXXXXXXXXXXXXXXXXXXXXXXXXXXXXXXXXXXXXXXXXXXXXXXXXXXXXXXXXXXXXXXXXXXXXX
