-----------------------------------------------------------------------------------------------------------------------------------------------------------------------------------------------------------
----------------o------------------------------------------------------------------------------XXXXX------------------B---------BBB----------------------------------------------------o-------------------
--------------------------------------------------------Bo------------X---o--------------------------------------------------------------------------------------------------------------o-----------------
-----------------------------------------------------------------o---o---------------X---------------------------------------------------------------------------------------------------------------------
--------------------------o-----X----B---------------------------------------------------------BB-------------------------X--------------BBBBBB-------------------------?----------------------------------
----------------------o----o-----------------BBXBBBBB------------XX-------o--BBBBBB--------BBB--------------o-------------------BBBBB------------------------o--------X------------------------------------
-o---------B------------------------------B-----------------------------o-----------------------------------------------------------------------------------------------------o------o---------------------
---------------------------------BB---------BBBBBBBX-----------------------BB?BBB----------B---------------------o------X----------------------------------------------B-------------------------------v---
-----------------?---------------------------------------B-------------------------------------o--------BBBB-------------------BBBBB---BBB------------------------------------------X-------o----------f---
-----------------------------?---------o------------T---------------------o----T----------?????-----------------BBX---o------------------------------------o-------------------X-----------------------f---
-------------------o--------------------------------|--------------------------|--------------------o------------------------------o--------o----------------------------------------------------------f---
-------------X?-B?BB-------BBBX-BX----------X???--BB|B-------------?XX??B-BBBBB|BB-----TBBBB------BBBB--XX-----?????--------BBBBBB---BBBB---------o----------TBBBBBBXXX-o------------------------------f---
-X--o-------------------------------o----------o----T-------------------o------|-------|--------------T-------------------------------------T------T-o-------|------------------------------o----------f---
------------------------------------------X---------|--------------------------|-------|--------------|-------------------------------------|-----o|---------|-----------------------B------------?----f---
m---------------------------------------------------|--------------------------|E------|--------------|-------------------------------------|------|E--------|----------------------------------------EX---
XXXXXXXXXXXXXXXXXXXXXXXXXXXXXXXXXXXXXXXXXXXXXXXXXXXXXXXXXXXXXXXXXXXXXXXXXXXXXXXXXXXXXXXXXXXXXXXXXXXXXXXXXXXXXXXXXXXXXXXXXXXXXXXXXXXXXXXXXXXXXXXXXXXXXXXXXXXXXXXXXXXXXXXXXXXXXXXXXXXXXXXXXXXXXXXXXXXXXXXXXXX
