-----------------------------------------------------------------------------------------------------------------------------------------------------------------------------------------------------------
-------------------------o--------------------------o---------------------X---------------o-------------------------------------------o--------------------------------------------------------------------
-----------------------------------------------------------------o-----------------------------o-----o--------------------------------------------o--o------o----------------------------o-----------------
-------------------------oo-------------------------------X----------?B???------------------------o--------------------------------------------------------------------------X-----------------------------
---------------------------------------------------------------------------------------------X---X-------------------o-----------------------------------------------------------------------------o-------
---------------------------B------o--------------------BBBB-------------------------------------------------------------BBBBBBBB-------------------------X---------------------------o---------------------
-------------o-----------------o--------------------------------------o----B-------------B---------------------------------------------------------o-------------------B--B--------------------------------
----------B-----o-----------------o------------BBB-----BBBBB---------???---------------------------------BBBB----------------------------X----------------------B--------------------o---X-------------v---
----------------------T----------------------X---oBBBBB-------------------T---------o-------------------------------------o-------X-------BBBB----------o----X-----------------------------------------f---
----------------------|---------------B--o-----------o--------------------|-?BBB---------BBBBBBXB---------o-------------XXXXX------------------------X------------B----?-------------------------------f---
----------------------|----------o-------------------T-------TT-----------|------------------------------------------------------o--------------?-----------X-------------o--------X-------------------f---
--------------BBBBBBBB|BBBBB-----X----------BBBBBBBB-|-B-BXX-||----------?|-?-?B??---BBBXBBBX-BBX-------BBBX----BBBB?????--o------BBXBBBBBBBBB--------T--------------------------X---------------------f---
----------------------|--------------------------T---|-------|TT----------|--------------------------------------o------------------------------------|-o--------------------------------------X-------f---
--------o-------------|--o-----------------------|---|-------|||----------|-----------X------------------------------o--------------------------------|------------------------------------------------f---
m---------------------|--------------------------|---|-------|||-----E----|----------------------------------------------o----------------------------|------------------------E--E--------------------X---
XXXXXXXXXXXXXXXXXXXXXXXXXXXXXXXXXXXXXXXXXXXXXXXXXXXXXXXXXXXXXXXXXXXXXXXXXXXXXXXXXXXXXXXXXXXXXXXXXXXXXXXXXXXXXXXXXXXXXXXXXXXXXXXXXXXXXXXXXXXXXXXXXXXXXXXXXXXXXXXXXXXXXXXXXXXXXXXXXXXXXXXXXXXXXXXXXXXXXXXXXXX
