-----------------------------------------------------------------------------------------------------------------------------------------------------------------------------------------------------------------
-------------------------------------o---------------------------------o-------------------o---o-----------------------------------------------------------------------------------------X-----------------------
------------------------------o-----------------------------o----o----------------o------------------------------o-------------------------------------------------o---------------------------------------------
-----------------?--------------o-------------X--------------------------------------------------------------------o---------------------------------------------------------------------X-----------------------
------------X------------------------X-------------------------------------------------------BXB--BB----------------------------------------------------X--------o-----------------------------------------------
-------B--------------------------o-X------------------------X--o--------------------------------------------------------------X-o-----------X---?---------------B---o-----o-------------------------X-----------
---------------?--o-----------------------o----o------o-------------------------------------------o----o-------------------o---------------------------o--------------------?----------------?--o----------------
-----------------B-----------------------------------------------------------------B---BXBBBB-B------------X--------------E----------o----------------X---o?-------------------------------------------v---------
-o-------------o----------B---------------------------------BX------------BBBB-XB---o--------------------------o------X?????---------------------------------T---------------------------X-------------f---------
--------------------oo---o----------T----------------------B--X----------------------------------o---------BBB-----------------------------------------------|---------------X-------------------------f---------
------------------------------------|----T-----?------T------------------o------------------------o--T-----------------------------------------------------o-|--------------------------------o--------f---------
----X------------------------------X|B-BB|----?----B--|--o--B-XB-BT-o----B-----------XXXXX-----------|-----o--------BBBBB----------------------T--------o---B|B-------------------------X--------------f---------
------------------------------------|----|-T----------|-----------|------------------------o------T--|---TT--o-----------------------X---------|---o---------|-----------------------------------------f---------
--------------X---------------------|----|-|----------|-----------|--o--------B---------------o---|--|---||------------------------------------|-------------|------------------------------X----------f---------
m-----------------------------------|----|-|----------|--o--------|--o---------------E------------|-E|---||------------------------------------|-------------|--E--------------------------------------X---------
XXXXXXXXXXXXXXXXXXXXXXXXXXXXXXXXXXXXXXXXXXXXXXXXXXXXXXXXXXXXXXXXXXXXXXXXXXXXXXXXXXXXXXXXXXXXXXXXXXXXXXXXXXXXXXXXXXXXXXXXXXXXXXXXXXXXXXXXXXXXXXXXXXXXXXXXXXXXXXXXXXXXXXXXXXXXXXXXXXXXXXXXXXXXXXXXXXXXXXXXXXXXXXXXX
