-----------------------------------------------------------------------------------------------------------------------------------------------------------------------------------------------------------
------------------B-----------------------------------------------------------------------------------------------------------------------------------------------X----X-----------------------o-----------
--------o----o--------------------o---------------------------------------------------------------------------------------------------------------------o------------X-------------------------------------
------------X------------------------------------------------------------------------------------------------------o-------------------------------------------------------------------------------o-------
------------------------------------------------------------o-----------------------------o--------------------------E---------------o-------------------------X----------------o--------------------------
-----------------------------------------------------------------------------------------o-----------------BBB-BBXBBBBB---------------------o---------------------------------X----------------o-----------
-----------------------------------------------------------------?--o--------------------------------?-------------X-?------------------------------B-------------------------------------o----------------
-o--------------------------Xo-------------------------------------------------------------------------------o------------------BBBBBB-----------------------------------------------------------------v---
-----------------------------------------------------------------------------------------------------------------------------------------------------------------------------------o---o---------------f---
-----X-------------------------------------------------------------------------------------------------BBB-XBBBB-----------------------------?--------XXXXX----------o----------------------------o----f---
-------------------------------------o-----------------------------T---------------?----------------------------------------------------B-----------B----------------------------------------o---------f---
-------------------XXXXX------------------------------------XX?XXXX|--------XXXXX----BBBBBBBB------X-?XXX???-----BBB--BBB-----XBBBBXBB----------------------------------------------------------------of---
-------------------------------------------------------T-----------|------T---------------T----------------------X----------------o-------------------------------------------------------------?------f---
--------X------------------------------------X---------|-----------|------|---------------|-------------------------------------------------------------------B------X---------------------------------f---
m---------E--------------------------------------------|-----------|------|---------------|-------------------------------------E----------------------------------------------------------------------X---
XXXXXXXXXXXXXXXXXXXXXXXXXXXXXXXXXXXXXXXXXXXXXXXXXXXXXXXXXXXXXXXXXXXXXXXXXXXXXXXXXXXXXXXXXXXXXXXXXXXXXXXXXXXXXXXXXXXXXXXXXXXXXXXXXXXXXXXXXXXXXXXXXXXXXXXXXXXXXXXXXXXXXXXXXXXXXXXXXXXXXXXXXXXXXXXXXXXXXXXXXXX
