-----------------------------------------------------------------------------------------------------------------------------------------------------------------------------------------------------------
--o--------------------------------------------------------------------------------------------------------------------------------------------------------------------------------------------------------
-----------o------------------o----------------------------------------------------------------------------------------------------------------------------------------------------------------------------
---------------------------------------------------------o--------------------------------------------------------------------------B----------------------------------------------------------------------
--------------------------------------------------o--------------------------------------------------------------------------------------------------------------------------------------------------------
-----------------------------------------X-----------------------------------------------------------------------------------------------------------------------------------------------------------------
----------------------------------------------------------------------------?--------------X--------------------------------?------------------------------X-----------------------------------------------
-----------------------------------------------------------------------------o-------------------------------------------------------------------------------------------------------------------------v---
-------------------o--------------------o--------------------XXXXXXXX------------------------------------X--------------o---X-------------------------o------------------------------------------------f---
-------------------------o----------XXBXX?XX------------------------??-----------------------------------------------------?????---------------------?-?---------X----------------------------------X--f---
------------------------------------XXX----------------------------------XXXXXX--------------------------------------------------o--------XXXXXXX-----------------------------------------X------------f---
-----------------------o--------------------------------------------XBXXXX--------------------------T------------XXXX---------------------------------o-------------X?---------------------------------f---
-----------------------------------------------------------XXXXXXX---o------------------------------|-------------------------------------o-------------------------------------X----------?-----------f---
--------------------------------XXXX----------------X--XBXXXX---------------------------------------|---?---------------------------------------------------------------------------B------------------f---
m-E-----------E--------------------------------o----------------------------------------------------|------------------------E-------------------------------------------------------------------------X---
XXXXXXXXXXXXXXXXXXXXXXXXXXXXXXXXXXXXXXXXXXXXXXXXXXXXXXXXXXXXXXXXXXXXXXXXXXXXXXXXXXXXXXXXXXXXXXXXXXXXXXXXXXXXXXXXXXXXXXXXXXXXXXXXXXXXXXXXXXXXXXXXXXXXXXXXXXXXXXXXXXXXXXXXXXXXXXXXXXXXXXXXXXXXXXXXXXXXXXXXXXX
