--------------------------------------------------------------------------------------------------------------------------------------------------------------------------------------------------------------
--------------------------------------------------------------------------------------------------------------------------------------------------------------------------------------------------------------
-----------------o------------------------------------------------------------------------------------------B-----------------B-------------------------------------------------------------------------------
-------------------------------------------------------o------------------------------------------------------------------------------------------------------------------------------------------------------
-------------------------------------------Xo------------------------X--o-------o--X------------------------------------X-------------------------------------------------------------------------------------
-------------------------------B--------------o-------------------?------------------------------o-------------------------------------------------X-----------------------------------------------o----------
------------------------------------------------------------------------------------------------------------------Xo-B----------------------------------------------------------------------------------------
-------------------------------------B----o----------XXXXX--------------------------BBB--------------------------X-------o-o---------o-XXXXXXXX----------------------X-------------B-------------------v------
----------------------------------------------------------------------------------o------------------------------------X---------------------------------------------------------------o---------------f------
-----------------------------------------------------------------------------B-----------------------------------o-----------------o--X-------------------------o?-------------------------------------f------
-----------------------------------------------------------------------------------------------------T-------------------o-oX--Xo-----------------------------------B----------------------------------f------
-----------------X------------XXXXXXX-------XXXX-XBXXXXXX------XXBXXXXX--BBB------BBBBBBBB-----XXXX--|-----------------------------XXXXXXXX--------------XXXXX--------?--------------------?-----------f------
---------------------------------------------------------------------------?-------------------------|----------------o-------T-------------------o--------------------------------------o------------of------
-------B---------------------------------------------------------X-------------------------------o---|------------------------|----------------------------------------------------------------------?-f------
m-E-----------------------------------------------------------------E------------------E-------------|---------E--------------|-----------------------------------------------------------E------------X------
XXXXXXXXXXXXXXXXXXXXXXXXXXXXXXXXXXXXXXXXXXXXXXXXXXXXXXXXXXXXXXXXXXXXXXXXXXXXXXXXXXXXXXXXXXXXXXXXXXXXXXXXXXXXXXXXXXXXXXXXXXXXXXXXXXXXXXXXXXXXXXXXXXXXXXXXXXXXXXXXXXXXXXXXXXXXXXXXXXXXXXXXXXXXXXXXXXXXXXXXXXXXXX
