-----------------------------------------------------------------------------------------------------------------------------------------------------------------------------------------------------------
-------------B----------------------------------------------o----------------------------o--------------------------------------------------------------------------------------------------------o---o----
------------------------------------------------------------------------------X-------------------------------------------------------X---------o--------------------------------------o-------------------
---X-------------------------------------------------------------------------------------------------------------------------------------o---------X---------------------------------------------X---------
------------o-------------------o------------------?------o-------X---------B-------------------------X---------------------------------o------------------------------------------------------------------
-----------------------X------------------X------------------------X--------------X-X-------------------o----------B-------------------------------------????-------------------X--------------------------
------------------------------------------------------------------------------------------------o---------------X-------------X----------------------------------------X---------o-------------------------
----------------------B----------------------------------------------------XBo--------o------------------------X----------------------------o--------BBBBBXB----------------------------o--------------v---
-------X---------?---------------o-------X--------------------------X-----------------------------------------?--oBBBBBBXB------------------BB---------------------------------------------------------f---
---------------------------------------o-------???X------BBBBBBB-------------------------------------BXXXBBB------------------------o-----------------------------------------o------------------------f---
--------------------------B-------------------X--------------------------------T----------------------------------------------------T-----------------------------o-------------------------o---X------f---
--------------------XBB--------XBXB-XBX--------BBB-----B?B-----XBBB----T---BBBX|-????----------BBB-XXXX---o----????-----------------|--o---T--BBB--XX??---BBBBBB---------------------------------------f---
----------------------------------------o------------------------------|-------T-------T------T----o---------------T----------------|------|--------------------------------------------o----B---------f---
----------------------------------------------------o------------------|-------|---?---|------|-o------------------|----------------|------|--------------------------------------------------------Bo-f---
m----E-----------------------------E-----------------------------------|-------|------E|------|-------------E------|----------------|------|--------------------------------------------------E--------X---
XXXXXXXXXXXXXXXXXXXXXXXXXXXXXXXXXXXXXXXXXXXXXXXXXXXXXXXXXXXXXXXXXXXXXXXXXXXXXXXXXXXXXXXXXXXXXXXXXXXXXXXXXXXXXXXXXXXXXXXXXXXXXXXXXXXXXXXXXXXXXXXXXXXXXXXXXXXXXXXXXXXXXXXXXXXXXXXXXXXXXXXXXXXXXXXXXXXXXXXXXXX
