-----------------------------------------------------------------------------------------------------------------------------------------------------------------------------------------------------------
-----------------------------------------------------------------------------------------------------------------------------------------------------------------------------------------------------------
-----------------------------------------------------------------------------------------------------------------------------------------------------------------------------------------------------------
-----------------------------------------------------------------------------------------------------------------------------------------------------------------------------------------------------------
-----------------------------------------------------------------------------------------------------------------------------------------------------------------------------------------------------------
-----------------------------------------------------------------------------------------------------------------------------------------------------------------------------------------------------------
-----------------------------------------------------------------------------------------------------------------------------------------------------------------------------------------------------------
----------------------------------o-------------------------------------------------------------------------------------------------XXXXXX-------------------------------------------------------------v---
-----------------------------------------------------------------------o----------XXXXXXXX------------------o------------------------------------------------------------------------------------------f---
-------------------------------------------------------------------------------------------------------------XXXXXXXX----------------------------------------------------------------------------------f---
-------------------------------------------------------------------------------------------------------------------------------------o------------T----------------------------------------------------f---
--------------------------------XXXXXXXX---------------------XXXXXXXX-XXXXXXX----XXX--------XXXXX-----------XXXXXXX--XXXXXXXXXXX---XXX------------|----------------------------------------------------f---
--------------------------------------------------------------------------------------------------------------------------------------------------|----------------------------------------------------f---
--------------------------------------------------------------------------------------------------------------------------------------------o-----|----------------------------------------------------f---
m---------------------E----------------------------E-------------E-----------------o--------------------------------------------------------------|----------------------------------------------------X---
XXXXXXXXXXXXXXXXXXXXXXXXXXXXXXXXXXXXXXXXXXXXXXXXXXXXXXXXXXXXXXXXXXXXXXXXXXXXXXXXXXXXXXXXXXXXXXXXXXXXXXXXXXXXXXXXXXXXXXXXXXXXXXXXXXXXXXXXXXXXXXXXXXXXXXXXXXXXXXXXXXXXXXXXXXXXXXXXXXXXXXXXXXXXXXXXXXXXXXXXXXX
