-----?--o-T---B|o---B-E---M----X----XE-----X-|---B-------X-------M--MXBXXMo--B-Xo----T-------E-T--M-----M|--?E-----oB--E-E-M--T-T---TM-XMB-----|----XTE--|E-----------E-------M-----X--||---B-----------
-E|----TTB--?---?--T-|X-----------|------|----o-----E-----oX-------|-------------E-----T-------M--M-TB-T-MB-M-----E|M--?-Xo-------B----T---E-|-----T-B---T?oT------T--M----TE----EM-MTX--X----B--T----X-
-M--o--B----M-----T-----B-B--|----X-M-------X---M------E---------||B------o-B-----E-MX----TTEo-----T--B-?oE---X--T----|---X---M-E?----|-?----MX?---------T-M-o--B?M---|T-?--------------------XM----o---
-TE----o--?B----E--X-X--?--?--E-----?T-----B|---T--|----M|----M-T--|---------T-X--B?-E-E----X-------------------?MT---|--|---E----T-?---T-----B-M|T-M------M-M-----oXo----X---|T--?---E--B---E----M|M---
------T-X---?TM----X-------X-----E---M--B-M-o-X---?B----------?---E----T--X----M-|---TBEo-B-T---?M|---T---T---oB-B---BM-|?--B-o---X-T---ooE-X---------------------T--o-----|----E---|M---T--|---X-------
----?------X?----------B-X-X-BB--TTBTo-oX--|XM-?|-------M-o-B--T-o-M-------------T----------Eo--TXo?B---M|----o-----------M----X----M--X-----B----B-E----------o----XM-|BM------B--B---------?-T---ETo--
--B?-----T---E-----M-----------|----oM--------?--T--------|-X---XB--?-|----T---------T--To------B----o-|--BE--M-E?X--M?--|E-o--E----o--o--M-----|--B--E-----------T-----T-------?E-E-----BE-X----B--M?--
-|----MT-TM--oM----T--E-Bo?-X?----?---X-X-X-?----E--EM--o--------M-----------MT--T--M------o---X---T-BX-T---?-B-oo--T---E-B--B--Eoo--?---E--------o-M----X-T-E-M-----|-----------?--|-To--|----M----T?-v
-M--?ME-M----M----?-----o---E-------------X??-?oX-E----|Mo-----?X--E--B?--B-----?-X-E-M?--------XM--|-?-MX---o---To--T--o-------M--------X----Xo-X|-----T-------|X|-----|-----------EM-E---o?M-o-------f
-----T---B--|B---o----|?-?X?M-M---B-----M------oo-----T--E-B|----X---oo--T-?E------?--M--|o?---T--|o----?-X-|------o----MXo-----X--T--B-E-----o?-M----?---B------MB--------o---TM---XT-|----------o-o--f
-------XT----TBM----?-B-E-E--XM?-E--ooT--T---|---B---E-----oXX------X------ET--?--BB-M-------|-|T-|--X----B----------X----------XE-----X-TM---TBX-------------|o-oo-o------|---T---?To-o-TX?---M--oM-|-f
--E-E-?-oE--o----------------o?-----E-?-|B-----T--T----X---?-M--B-|-|MT?--M-o--TE--------?--M-X-|o-----------o----E----|M---Bo--?--X-------o----B?--B---|BX---?TXE--E|X-----o--E-|-X--|-----E?---B?----f
---B--E---|XE-XM--XM-??-----X--o--T--E-o---T----|B-E--M------o?M---X---?-------?-M---o-o---BTo-------E--M----XT---B-----B---|---------T|------To|--B-B--------X---o-EB--E----M-BE--B-T--M--------E---??f
---XM--o|-E??-EM-E----oX--o--B|---X-?--X--E?-----------M----XT-M----------?--o--E--o---||-----M--X--o-----|o-B------|----X--M-E--?-?|M-?T--oE||-|T-----M---|-E--TE--?-|-T?|------E----ET|----TB-BM-X-B-f
m--X----?-|T--XME--|--M---B-BX---o----X|-X--XX--X--Mo----MXX-M?-----TXEX?--|--B-X-ToT-XT--M---T---?-----|o--o-E?-X--X-?--o---B----TB--?E-o-MM-T--BX--BM-E-?------M------------T?-----E---o--M|----o-|--X
XXXXXEXXXXXXXXXXXXXXXXXXXXXXBXXXXXXXXXX-XXXXXXX-XBXXXXXXXXXXXXXXXXXXXXXXXXXXXXXXXXXXXXXXXXXXMXXXXXXXXXXXXXXXXXXXXXXXXXXXXXXXXXXXXXXXXXXXXXXXXXXXXXXXXXXXXXXXXXXXXXXXXXXXXXXXXXXXXXXXXXXXXXXXXXXXXXTXXX-X
