-----------------------------------------------------------------------------------------------------------------------------------------------------------------------------------------------------------
-----------------------------------------------------------------------------X----------------------------------------------?------------------------------X-----------------------------------------------
-------------------------------------------------o------------------------o---------------------------------------------------o---------------?------------------------------------------------------------
-----------------------------------------------------------------------------------------------------o---------------------------------------------------------------------X-------------------------------
-------------------------------------?--------------------------------------------------------------------------------------------------------------------------------------o------------------------------
------------------------------------------------------------------------------------------------------------o--------------------------------------B--------B----------------------------------------------
---------------------------------------------------o---------------------------------------------------------------------------------------------------------------------X---------------------------------
--o-------------------------------------------------------------------------------X----o----------------------------------------------------------------------------------------------------------o----v---
-------------------------------------XXX------------------XXXXXX----------XXXXXX-----------------------XXXX--------------------------------------------------------------------------------------------f---
-------------------------------------------------XXXX-X--------------------------------------------------------XXXXXXXX----------------------------B---------------------------------------------------f---
---------------------------------------------BBBBBXXXXXX-----------------------------------------------------------------------------------------------------------------------------------------------f---
---------------------------------o-------XXX------------------------------X--------------o-----------T------------------------------------XXXXXX-------------------------------------------------------f---
-------------------------------------------------------------------------XXXXXX-------------o--------|--------------o--T-------------------XXXXXXX-----------X-----------------------------------------f---
------------------------o-----BBBBXB----------------------------o------------------------------------|-----------------|-------------------o-----------------------------------------------------------f---
m------------------------------o----------E-----------------------------------------E----------------|-----------------|-----------------------E-------------------------E-----------------------------X---
XXXXXXXXXXXXXXXXXXXXXXXXXXXXXXXXXXXXXXXXXXXXXXXXXXXXXXXXXXXXXXXXXXXXXXXXXXXXXXXXXXXXXXXXXXXXXXXXXXXXXXXXXXXXXXXXXXXXXXXXXXXXXXXXXXXXXXXXXXXXXXXXXXXXXXXXXXXXXXXXXXXXXXXXXXXXXXXXXXXXXXXXXXXXXXXXXXXXXXXXXXX

