-----------------------------------------------------------------------------------------------------------------------------------------------------------------------------------------------------------
-----------------------------B-----------------------------------------------------------o------------------------Xo-----------------------------------------------------o-----------o---------------------
--?----------o--o----------------o-----------------------------------------------------------------------------------------------o-------------------o----------o------------------------------------------
-----o----------o-----o------------------------?--------o----------------------------------------X---?-------------------------------------------B---------------------------------------------------------
--------------------------------------------o--------------------------------------o--------------------o-------------------------o-----------------------------------------------------o------------o-----
---o----------------------------------------------------------------------X----------o------------o-----------o----X-o-----------------------------------X--------------------X---------o------------------
---------------------------B------------o---Bo------------------o-----B----------------------------------------------------------------------------o---------o---------------------?-----------------------
---------------------X------------------------------------------------o--------------------------------oo----?----------------------B----------o------------------------------------------------o------v---
----o-----X-----------------------------------X----------o-o-----------X-----------------------------------------------------------------------------------B---------------X---------------------------f---
-------oo---------------------------------------------------------------------------------------T------------o----------X---------------------------------------?--------o-----------------------------f---
----------------------------------------------------------------------------------------o-------|-------------------------oB----X----------------------------B-----o--X--------------X----o------------f---
----X------B----B--------T-----?-----------T----------------------------o------------------T----|---------------------------------------T----------------------B--------?-X--------------B-------------f---
------------------o------|-------------o---|-----------------------------T-----------------|----|o---------------T----------------------|----------------------T---------------X-----------------------f---
--o---------o------------|-----------------|X------------------oX--------|---------------o-|--o-|----------------|----------------------|-o--------------------|--------------X---------o--------------f---
m-o----E-----------------|---------------E-|-----------------------------|---------E-------|----|----------------|----------------------|-----E-----------o----|---------------------------E-----------X---
XXXXXXXXXXXXXXXXXXXXXXXXXXXXXXXXXXXXXXXXXXXXXXXXXXXXXXXXXXXXXXXXXXXXXXXXXXXXXXXXXXXXXXXXXXXXXXXXXXXXXXXXXXXXXXXXXXXXXXXXXXXXXXXXXXXXXXXXXXXXXXXXXXXXXXXXXXXXXXXXXXXXXXXXXXXXXXXXXXXXXXXXXXXXXXXXXXXXXXXXXXX
