-----------------------------------------------------------------------------------------------------------------------------------------------------------------------------------------------------------
--------------X--------------------o----------------------------------------------------------------------------------------X-----------o---o--------------------------------------------------------------
-------------------------------------------------------------------------------------------o---------------------------------------------------------------------------------------------------------------
-----------------------------------------------------------------------------------------------------------------------------------------------------------------------------------------------------------
------------------------------------------?--------------------------------------------------------------B----------------------------------o-o-------------------X----------------------------------------
-------------------------------------------------------------------------?---------------------------------------------------?-----------------X-----------------------------------------------------------
-------------------------------------------------------------o-------------------------------o-------------------------------------?-----------------------------------------------------------------------
-------------------------------------------------------------------------------------------------------------------------------------------------------------------------------------------------------v---
--------------------------------------------------?------------X-----------------------------------X------------------XXXXXXXXXXX--BBB------------------X-----------------------------------------o----f---
------------------------------------------------------------XXXXXXT--------------XX?XXXX----?XXXXXX----------------BBBBBB--------------------------------------------------------o---------------------f---
--------------------------------------------------XX--------------|-----T------------------------------BBBB------------------------------------------------XXXXXXX------------------o------------------f---
--------------------------XXXXXX-------------------------XXXXXXX--|-----|------o----------------------------------------------------------o-----XXXX---------------------------------------------------f---
-----------------B--------------------------------XXX-------------|-----|------------------------------------------------------------T-------------------------------------------------?---------------f---
-----------------------------------------------------BBBXBBBB-----|-----|??????---XXXXXX---------------------------------------------|----o--------o---------------------------------------------------f---
m---------------------------------------------------E-------------|-----|--------------------------------------------------------E---|-----------------------------------------o-----------------------X---
XXXXXXXXXXXXXXXXXXXXXXXXXXXXXXXXXXXXXXXXXXXXXXXXXXXXXXXXXXXXXXXXXXXXXXXXXXXXXXXXXXXXXXXXXXXXXXXXXXXXXXXXXXXXXXXXXXXXXXXXXXXXXXXXXXXXXXXXXXXXXXXXXXXXXXXXXXXXXXXXXXXXXXXXXXXXXXXXXXXXXXXXXXXXXXXXXXXXXXXXXXX

