-----------------------------------------------------------------------------------------------------------------------------------------------------------------------------------------------------------
----------------------------------------------------------------o------------------------------------------------------------------------------------------------------------------------X-----------------
----------------------------------------------------------------------o---------o--------B-------------------------------------------------------------------------o---------------------------------------
----------------------?-----------------------------------------------------X-------------------------------------------o------o--------------------------X------------------------o-----X-----------------
----------X--------------------------------------o---------------X-----------------------------------------------?-------------X---------------------o--X--------o-----------------------------------------
---------------------------?----------X-----------------X-------B?------------------------------?---------o--------------o-------o-----------o---?---------------B---o-----o-------------------------B-----
---------------?-------------------------------------------------------X--------------------------------X----------------------------------------------o--------------------?----------------?--o----------
--------X---------------------------------------------X--------------------o-----------------X----------------------------E---------------------------X---o?-------------------------------------------v---
--------------------------B-------------------------------------------------------------o---------------------?X------X--???-X-------------------------------T---------------------------X-------------f---
--------------------o------------T------------o--------------------------------------------------------TBXBBBB-----------------------------------------------|---------------X-------------------------f---
-----------o--------------------T|--------------o------------------T--------T---------TT--------X------|---------------------------------------------------o-|--------------------------------o--------f---
-----o----------o---------------||-B--o----o-T------------o-------T|--------|XXXXX----||BBBBXBBB-BBB--B|BBX---------BBBo-o---o-----------------T------------B|B-------------------------X--------------f---
-----------X------------o----T--||-----------|---T-----------XT---||----T---|---------||---------------|-----------------------------X---------|---o---------|-----------------------------------------f---
-------o------o--------------|--||-----X-----|---|------------|---||----|X--|---------||-------------o-|----------------o----------------------|-------------|------------------------------X----------f---
m----------------------------|--||----E------|---|-------o----|---||----|---|---------||---------------|---------------E-----------------------|-------------|--E--------------------------------------X---
XXXXXXXXXXXXXXXXXXXXXXXXXXXXXXXXXXXXXXXXXXXXXXXXXXXXXXXXXXXXXXXXXXXXXXXXXXXXXXXXXXXXXXXXXXXXXXXXXXXXXXXXXXXXXXXXXXXXXXXXXXXXXXXXXXXXXXXXXXXXXXXXXXXXXXXXXXXXXXXXXXXXXXXXXXXXXXXXXXXXXXXXXXXXXXXXXXXXXXXXXXX
