-----------------------------------------------------------------------------------------------------------------------------------------------------------------------------------------------------------
---------------------------------------------------------------------------------------------------------------------------------o-------------------------------------------------------------------------
--------B--------------------------------------------------------------------------------------------------------------------------------------------------------------------------------------------------
--------------------o--------------------------------------------------------------------------------------------------------------------------------------------------------------------------------------
-----------------------------------------------------------------------------------------------------------------------------------------------------------------------------------------------------------
---------o--------------------------------------------------------------------------------------o----------------o---------------------------------------------------------------------o-------------------
----------------------------------------X----------------------------------------------------------------------------------------------------------X-------------------------------------------------------
------------------------------------X-----------X----------X-------------------------------------------------------------X-----------------------------------------------------------------------------v---
-----------------------E------------------------------?????-X----o-----?-------------------B----------------XXXXXXX--------------XXXXXXXB-------?------------------------------------------------------f---
---------------------XXXX-------------------------------------------------XXX----------------------------------------------------------------------------------------------X---------------------------f---
---------------------------------------------------------------------------------------XX?----XXXXX-------------------------------------BBBBBBBB-------------------------------------------------------f---
------------------------o---XXX----o--------------------------XXXXX---------BBB--------------------------------------------------------------------------------------------------X------------------o--f---
-----------------------T-----------------??T?------------------------BB--------------XXXX-----------------o---?XXXX-----------------------------------------------------XXXXXXXX-----------------------f---
-----------------------|-------------------|-------------------X??????-X-----------o-------------------------------------------------------------------------------------------------------------------f---
m---------------E------|-----------E-------|----o-------------------------------------------------------------E--------------------------------------------------------------------o-------------------X---
XXXXXXXXXXXXXXXXXXXXXXXXXXXXXXXXXXXXXXXXXXXXXXXXXXXXXXXXXXXXXXXXXXXXXXXXXXXXXXXXXXXXXXXXXXXXXXXXXXXXXXXXXXXXXXXXXXXXXXXXXXXXXXXXXXXXXXXXXXXXXXXXXXXXXXXXXXXXXXXXXXXXXXXXXXXXXXXXXXXXXXXXXXXXXXXXXXXXXXXXXXX
