-----------?---|-M----------To--E--X-----X--|-----B--X------|TBXE-|E----B-T----E-T-|-o-------M---------B----?--|-M-------T----|----------B-B----------M--o--E-------X-?--M---M------------o---------?-EB
|T------E-------|--------------Eo-------------------------M--|-------?-TMT----|----------T?-----B-M|--------T-----------E----X---M--B-----E-o------|----T-Xo------T-B------|X--------|ME---------o----|o
-M?-|EEX----|----?M-M-------?---------T---B---------B--|-----M-M---T-T-M---------B-E--B--T-?----B--XB--M--|---B---E--E-E-E-B---T------M------E----XM-M---------B--?E--BBT--X------|o----T--B--o----?B--B
?--|B|----|---B?-----|XE--|--------?--Eo----E--------|------|X--T--B--E|-----X-M|-o----X-------X-B-----T--o--E--------B-E--------o-----------------o-o?---------M----X--B-?----E|-M--o-B-------o-?T-B---
T--|-?-----------------XB----E-----o---o-X--B-?T---B---------------------o----------B-oo---B---o----X-----B--T-----------o|----?--B------------T---B--TT-EE-----o|oM---T--EXo-?------o--B--?|X------M--M
oE-----M-Eo-?--|---??------?E---E--------X-E--X-----T------ET-M----------?Eo-E----X------B-------------?--BB--|----------T-M---------o-?---XM--B?-|--E-----?-----E-oX--M--E---|X-T-----Bo------T---?---B
M-------?|T-o--X--o------TEX?X-----------?-|-ET-X--B---------?----T?--------E|-------?-o----M---B--X--------|--------M-------|-?-----------------B-------E----M-oM-----M-------T-------------o---------|
o----M-MX--?---|--X--|--B-T---X?---B--M--|------T-E--M-----M--TE-M----EE-----T-o---B--M---------|---------M?-------------ME-E----X?MT--E-------MXM----|----X----?---------X|-------o------E----M--B-TT-v
|----B-E-?-------?B--------?---?------M--------BEB----?-T-MX---B--o-----X--?-----MX-|-B--------B?---o------|-M--|---M-------X--------------E---T-X-----BM--T-B--------B-X-----M-oT----T--o-----BM----|-f
|--M-Bo---?-----------------E--X---B-M--T------|----M-----oo-----|----|---BB---T--M---------?-T||o|---M--|--------E----E----T--BM-EoX-----T------X----o---|X-----?-o----o---TE----E-------E-T-------B--f
E---E---------------------E-X|--T--?-----o---------ME--M-|-?E-B-------T?----------XBMB---------------|--M|--------------BX----T----TB-----T|---?-B-T||-----M-X---------o-----EM-----------M--?----|----f
ToM-E-|E----T-----M------BT--E-T-------X---B---T-------?----E---o---T------oT----B-----|-----o?----o--------------B----------------o-------T-M---------E-X---------|-----|Eo?---X-|-----oM-TM----o?--M-f
|-------E--------E-----To---oB-------|-|----o--|--M-|---?--X-------X--------X---------?----------|-X---ET--o-------o---------------M-XM|-E---E--E---------B--B-----?B--o--------o----T-ME-----M-|TX----f
XX--o----M---|-X?-----??X-----M-----E---T--o--B-M|M----X-E----|E---------------T----E-T-B-X---|----|----------E-------------E-----B-E--X-X---E-------M----|-?-?o-|---TE----X---?-----|--B-----?T----X--f
m---E-----|--E-------B----E----B---------------------------T---o--Eo-o-T------E---E------MB-----------M-TX-o-T--XX--X------|T----|o--E--o-o------E-------X--T----?--|------E------o-----o-----?-o--EB--X
XXMXXXXXXBXXXXXXXXXXXXXXXXXXXXXXXXXXXXXXXXXXXXXXXXXXXXXXXXXXXXXXXXXXXXXX?XXXXXXXXXXXXBXXXXEXXXXXXXXXXXXXXXXXXXXXXXXXXXXXXXXXXXXXXXXXXXXXXXXXXXXXXXXXXXXXXXXXXXXXXXXXoXXXXXXX|XXXXXXXXXXXXXXXXXXXXXXXXXXX
