--------------------------------------------------------------------------------------------------------------------------------------------------------------------------------------------------------------
-------------------------o----o-------o----------------X--------o-------------o-----X------------------B-----X-----------o-----------------o--B-----------B----o----------------------------------------------
-----------------------------------------------------?-----------------------------o-----------------o--------------------------------------?---o--o----------------------------------------------------------
--------------------------------------------o--------------------------------------------------------o---------------------------------------------------------B------------------o---------------------------
------------------------X-----------------------------BB------------------o----------E------------------o--------------------------------------------o--o-------------X------------------o--------------------
--------------X-----B---------BBB--------------XXXX---------XBB----------------BBB-BBB------------??------------o-BBBBB----B--------------------------B?BBBB---------------?----------------------------------
-----------------------------------------------------------o---------B---------?------------BB------------B--BBXB-------------o----------------------------------o--oXX--------------B------------------------
------------------------------XBBBBBB-------XXXX--------------o----------------BXBBB-------------X--o-------------------XXXXXXXX---------B?BBBB-----------------------------------------------X--------v------
-------------------X-----------------------------------------------------------E------------------BBBB-----------BBXB-oT-------------------------------------------------XXXXX-XX----------------------f------
-----------------------------------------------TBBB------XXXXXXX---X?XXX-----BBB------XBBB?B-B-------------???---B-----|--------XXXX------------BBBBBBB-------B------B---------------------------------f------
-------------E-E------------------------------E|------------------E--------E---------E------------------E----E--E------|------------------B------------------o-----------?-B-------------o-------X-----f------
-----------BBBBB-------------BXBBB-----XBBBBX-B|BBBBB--BBBB-------BBBXXXX--BBBB--BBB-XBBBBXB--BBBBBBB-BBB?????--?XBB--B|BBB-XBBXBBBB---X-BBBBBBBBBB---BBBBBBBXB-------BBBBB----------------------------f------
-----------------------------------------------|---------------------------------------------T-------------------------|--------------------o--------------------------------------------X-------------f------
---------------------o-------o-----------------|---------------------------------------------|----o-------------o------|-----------o------X-----------------------------------------------------------of------
m-E------E---E-E-E------E--------EE-----E----E-|----E-E-----------E---EE-------E-EE-EE---EE--|-E-E-EEE--------E-E-----E|----------------E-o---E-E---------E----------------------E-----E---------------X------
XXXXXXXXXXXXXXXXXXXXXXXXXXXXXXXXXXXXXXXXXXXXXXXXXXXXXXXXXXXXXXXXXXXXXXXXXXXXXXXXXXXXXXXXXXXXXXXXXXXXXXXXXXXXXXXXXXXXXXXXXXXXXXXXXXXXXXXXXXXXXXXXXXXXXXXXXXXXXXXXXXXXXXXXXXXXXXXXXXXXXXXXXXXXXXXXXXXXXXXXXXXXXX
