-----------------------------------------------------------------------------------------------------------------------------------------------------------------------------------------------------------
-------------------o------------------------------------------------------------o--------------------------------------------------X----------------------------------------------o------------------------
--------------------------X-------------------------------------------------------o---------------------------------------------?--------------------------------------------------------------------o-----
----------------------------------------------------------?---------------------------------------------------------------o------------------X------o------------------------------------------------------
----------------------------------------X-------------------o--------------------------------------------------------E---------------------------------------------------X---------------------------------
---------------------------------------------------------------------------------------------X-------------BBB-BBXBBBXB--------------o------o------o-------------------------------------------------------
--------------------o-----------------------------------------------------------------------B----------------------X-----------------------o-----------------------X---------------------------------------
--------------------------------------------------------------------------------------------------------------------------------XBBBBB-----------------------------------------------------------------v---
-----------o--------------------------------------------------------------------------------------o------------------------------------------------------------------------------------o---------------f---
----------------------------------------------------------------------------------------X--------------BBX-BBBBB--------------------------------------XXXXX-------o-----?BBB--------o------------------f---
-----------------------------------T-------------------------------T---------------------------------------------------------------------o-------------------------------------------------------------f---
--------------------------?BB---BBB|BBB---BBB---------------XXXXX-X|--------XXXXX----XBBBBBXB--------???????-----BBB--XBB-----BBBBBXBB--------o------------------BBB--BBBBBB--------------------------of---
--------X--------------------------|-----o-------------T-----------|------T---------------T--------------------------------------------------------------------------------------------o---------------f---
-----------------o-----------------|o------------------|--?--------|------|---------------|--------------------------------------------------------------------------------o---------------------------f---
m-E-----E-------------------------E|--------E----------|-----------|------|---------------|-------------------------------------E------------------------------------E---------------------------------X---
XXXXXXXXXXXXXXXXXXXXXXXXXXXXXXXXXXXXXXXXXXXXXXXXXXXXXXXXXXXXXXXXXXXXXXXXXXXXXXXXXXXXXXXXXXXXXXXXXXXXXXXXXXXXXXXXXXXXXXXXXXXXXXXXXXXXXXXXXXXXXXXXXXXXXXXXXXXXXXXXXXXXXXXXXXXXXXXXXXXXXXXXXXXXXXXXXXXXXXXXXXX
