-----------------------------------------------------------------------------------------------------------------------------------------------------------------------------------------------------------
---------------------------o-------------------------------------------------------------------------------------------------------------------------------------------------------------------------------
-----------------------------------------------------------------------------------------------------------------------------------------------------------------------------------------------------------
-----------------------------------------------------------------------------------------------------------------------------------------------------------------------------------------------------------
-----------------------------------------------------------------------------------------------------------------------------------------------------------------------------------------------------------
-----------------------------------------------------------------------------------------------------------------------------------------------------------------------------------------------------------
-----------------------------------------------------------------------------------------------------------------------------------------------------------------------------------------------------------
--------------------------------------------------------------BBBB---------------------------------------------------XXX----------XXXXXX---------------------------------------------------------------v---
------------------------------------------------------------------------------------------o------------------------------------------------------------------------------------------------------------f---
------------------------------------------------------------------------------------------------------------------------------------------------------------------------------------o------------------f---
------------------------------------------------------------------------------------------------------------X------------------------------------------------------------------------------------------f---
---------------XXX-------------------------XXXXXXXX-----------XXXXXXX-------------------XXXXX-----------T-----------XXXX---------XXXX-X----------XXXXX---------o---------------------------------------f---
----------------------------------------------------T---------------------------------------------------|----------------------------------------------------------------------------------------------f---
----------------------------------------------------|---------------------------------------------------|----------------------------------------------------------------------------------------------f---
m-------E-------------------------------------------|----------------------------E----------------------|--------------------E--------------------------------------E----------------------------------X---
XXXXXXXXXXXXXXXXXXXXXXXXXXXXXXXXXXXXXXXXXXXXXXXXXXXXXXXXXXXXXXXXXXXXXXXXXXXXXXXXXXXXXXXXXXXXXXXXXXXXXXXXXXXXXXXXXXXXXXXXXXXXXXXXXXXXXXXXXXXXXXXXXXXXXXXXXXXXXXXXXXXXXXXXXXXXXXXXXXXXXXXXXXXXXXXXXXXXXXXXXXX
