-----------------------------------------------------------------------------------------------------------------------------------------------------------------------------------------------------------
------------------------------------------------------------------------------------------------------------X------------------------------------------------------o---------------------------------------
--------------------o------------------------------------------------------------------o-------------------------------------------------------------------------o-----------------------------------------
------------------------------------------------------------------------------------------------------------------------------------------------o----------------------------------------------------------
---------------------------------o--------------------------------------------------------------o---------------------XXXXXXX----------o--------------------------------------o----------------------------
-----------------------------------------------------------------------------------------------------------------------------------------------------------------------------------------------------------
-----------------------------------------------------------------------------------------------------------------------------------------------------------------o-----------------------------------o-----
----------------------------------o------------------------------------------------------------------------------XXXXXXXXXXX-------------?--o----------------------------------------------------------v---
--------------X---------------------------------------------------------------------o---XX-X-------------------------------------------------------------o---------------------------------------------f---
--------------------------------------------------------------------o------------------------------------B---------------------------------------------------------------------------------------------f---
-?------------------------------------------------------------------------------------------T----------------------------------------------------------------------------------------------------------f---
-----------------XXXXX---------X-XXXXX---XX?XXo------?????--------------XXXXBXXX--X--???????|----------------XXXXXX?XXXXX-o--------XXX---------------------BBBBBBB-------------------------------------f---
-----X-------------o------------------------------------------------------------------------|---------------o-------------------------------------------------X-------------------------o------------o-f---
-----------------------------------------------------B-----------------?--------------------|----------------------------------------------------------------------------------------------------------f---
m---------------------------E-------E-------------------------------------------------------|-------------------------------------------E--------------------------------------------------------------X---
XXXXXXXXXXXXXXXXXXXXXXXXXXXXXXXXXXXXXXXXXXXXXXXXXXXXXXXXXXXXXXXXXXXXXXXXXXXXXXXXXXXXXXXXXXXXXXXXXXXXXXXXXXXXXXXXXXXXXXXXXXXXXXXXXXXXXXXXXXXXXXXXXXXXXXXXXXXXXXXXXXXXXXXXXXXXXXXXXXXXXXXXXXXXXXXXXXXXXXXXXXX
