-----------------------------------------------------------------------------------------------------------------------------------------------------------------------------------------------------------
-----------------------------------------o--------------------o-----------------------------o------------------------------------o---o--------------------------B------------------------------------------
-------------------------?-------------------------------------------------------------------X----------------o-------------------------------------------o------------------------------------------------
--------------------------------------------------------------XXXXX--------?--?----------------------------------------------X--------o-B------------------------------------------------------------------
------------------------------------------o----------------------------------X-XXX-X---------------------o--XXX---o-----------X--?-o----------------------------o------------------------------------?-----
----------B---------X-------?-----B--------------------------o-----o-----------------------------oo-----------------X?XXX-X-o----------------------------X-------------------------------------------------
----------------X--------------------------------------o----------------------------------X-----------------------------------oX---------------?------------------------------X----------------------------
------------------------------------------------------------XXXXX-----------------------------------------?XXX----XXXXXX------------------------------XXXX---X----------X------------o------B----------v---
-----------------o-------------------------------------------------------------XXX-XXX------o-------------------------------------------o-----------------o----------o-------------------------------X-f---
---------------------------------------------o--------------------------------------------------------------------------------o---------------------------------------------X--------------------------f---
-----------------??----------o--------o-------------------------------o----------------------------------------------------------------------o----------B------------o---------------------------------f---
-------------XXXXXX-X-------------------XXXX----????---X--XXXX-----------??X??X?--XXXXX--XXXX--XXXXXX--XXXX-------XXXXXXXXXXXXX-------------------T---X---------XXXXXXXX-------------------B-----------f---
----------------------------o-------------------------------------------o-----X-o-----------------------------------------------------------------|---------------o------------------------------------f---
-----X---o---------------------------------------------o-----------------------------------------------------------------------------o------------|----------------------------------------------------f---
m----------------------E--------------------------E------------------------------------------E----------------------------------------------------|----------------------------------------------------X---
XXXXXXXXXXXXXXXXXXXXXXXXXXXXXXXXXXXXXXXXXXXXXXXXXXXXXXXXXXXXXXXXXXXXXXXXXXXXXXXXXXXXXXXXXXXXXXXXXXXXXXXXXXXXXXXXXXXXXXXXXXXXXXXXXXXXXXXXXXXXXXXXXXXXXXXXXXXXXXXXXXXXXXXXXXXXXXXXXXXXXXXXXXXXXXXXXXXXXXXXXXX
