-----------------------------------------------------------------------------------------------------------------------------------------------------------------------------------------------------------------
---------------------------o----------------o-----o-------------o---------------------------------???------o----------------------------------------------------------------o-------X--------o-------------------
------------------------------------------------------------------------------------------------o------------------B-B-BB-------------------X---o-----------------------------------------?----------------------
-------------------------o---BBBBB----B------X-----------------------------------------------BBBB------------------------------X-------?-----------------o-------------------------------------------------------
-------------------------------------------------------X------X--------------XBB-----------------B-------------------------X-----------------BB--------------o-o-------------------------o-----------------------
--------------X-----B----------------------------------------BB--------o------------------------E--BB-B--BBBo---------------------?-------------------BBBB?BB---------------------------------B------------------
----------------------o-------E------------------------------------------------------------?????X?----------o--BB-B--BBBBBX-B---------------B-B--o-----o------------oXX----o----X----------X---------------------
---------------------------X?B??--------BBB--------------------------------------------BBX--------------------------------o--------BBB--------E--------------------------------------oB----------------v---------
-------------------B--BBB-----E----------------------o----------o------------??????-------------------o---o--X-B---------o--------o--------BBBB--o--------------------------------------B--------------f---------
-----------------------o------BBB-o---------------o------XXXXXXX---?X?XX----X-------o--BB-BX---------oX--XXX----------BBB--------B-B----------T-BXBBBBB--------X-----B----------o----------------------f---------
-------------E-E----------E---E----------o------------E-----------E----------------------------------------o------------E------------------E--|------------------------E----------o-----o--------------f---------
-----------XBBBX------BB-XXXXXXX-BBB-BBBBBBB---BBBB---BX?BB-------XBBXXXBBBBB-------XXXXX?T?---XTXB---BB--BB-BB-----?B?-?---BB--BXBBBB?B--BBBB|BBBB--oXBBBBBX---------BB----------Bo-------------------f---------
------------------------------------------------------T-------------------o----------T----|-----|---------------------------------------------|-------------------o------o------------o---------------of---------
----------------------------------------o-------------|-------------------o--------o-|----|---o-|---------------------------------------------|---------------------------o-------o--o----------------of---------
m-E------E---E-E-E-----E-------E-E--E--EE--E----E-EE-E|-----------E---EEEE--E-----E--|E-E-|--E--|E------------E---E------------E--EE-EE-E--E-E|-E---------E--E---------E--------E----E-E---------------X---------
XXXXXXXXXXXXXXXXXXXXXXXXXXXXXXXXXXXXXXXXXXXXXXXXXXXXXXXXXXXXXXXXXXXXXXXXXXXXXXXXXXXXXXXXXXXXXXXXXXXXXXXXXXXXXXXXXXXXXXXXXXXXXXXXXXXXXXXXXXXXXXXXXXXXXXXXXXXXXXXXXXXXXXXXXXXXXXXXXXXXXXXXXXXXXXXXXXXXXXXXXXXXXXXXX
