--------------------------------------------------------------------------------------------------------------------------------------------------------------------------------------------------------------
--------------------------------------------o--------o-------------------------------------------------------------------o----------------------------------------------------X-o-----------o-----------------
--------------------------?--------------------------------------------------------------------------------------o-----------o--------------------?-----------------------------------------------------------
--------------------------------------------------X--BBX-------------------------------------------------------------------------------------o----------------------------------------------------------------
---------------------------------------o---------------?--------o-----------------------BB-B------------------------------------------------------------------------------------------------------------------
------------------------------------------------------------------------------------------------------------------o-B----------------------------------??-E---------------------------------------------------
---------------X-----------------------------------------------------o---------------------------o---------------------------------------------?---------BB------o--B------o----------------------------------
-----------------X---------o-------------------------???---------------------------------BX-----BBBB-?-?---------------------------------------------BB-B-------------X--------------------------------v------
--o-----------------B--------------X----------------------------------B------------B-BBB------------------------------T-------o--------------------------------------------X---------B-----------------f------
--------------------T---------------------------------------------------------------X-------T-------------------------|------------------o----------------T----------------------------------X---------f------
--------------o-----|---------------T--T----------------------------------------------------|---------------o---------|---------------o-----o---------o---|--------------------------------------------f------
-------------------B|BBBB-XXXXX-----|--|--BBBBBBBX?BBBBXBB-----BBBBXBBBX-B-----BBB--B----BBB|BX--???X-XXX----BBB---B-B|B-----BBBB---B-BBBBBX--T--ooB-BB--B|BBB----XX------------------------X----------f------
--------------------|--------------T|--|--------------------o-------------------------------|-------------------------|-----------T-----------|---T-------|---------------------------------o----------f------
---oo---------------|--------------||--|----------------------------------------------------|-----------X-------------|-----------|-----------|---|-------|-------------o------------------------------f------
m-------------------|-E-------E----||--|------------------------------------E---------------|-------------------------|-----------|---------E-|---|-------|-----------------------E----------------E---X------
XXXXXXXXXXXXXXXXXXXXXXXXXXXXXXXXXXXXXXXXXXXXXXXXXXXXXXXXXXXXXXXXXXXXXXXXXXXXXXXXXXXXXXXXXXXXXXXXXXXXXXXXXXXXXXXXXXXXXXXXXXXXXXXXXXXXXXXXXXXXXXXXXXXXXXXXXXXXXXXXXXXXXXXXXXXXXXXXXXXXXXXXXXXXXXXXXXXXXXXXXXXXXX
