-----------------------------------------------------------------------------------------------------------------------------------------------------------------------------------------------------------------
------X------------o--------------------------------------------------------------------------------------------------oX-----------------------------------------------------------------------------------------
-------------------------------------------X---------o---------B--------------------------------------------B---o--------------------o---------------------------------------------------------------------------
--------------------------------------------------------------------------------o----------------------------------------------------o----------------B------------X---------------------------------------------
------------------------------X-------o--------------------------------------------------------------------------o--------o------------------------------------------X---X-------------------------B-------------
--o------------------------------o---o-----------------------------X-o-----------------------o--------------------------o---------?-------B---------------?-------------------------------X----------o-----------
-?----------------------------------X---------------------------------------------------------B---------X-----------------------------X---------------------------X----------------------------------------------
---------------------B------------o-------------------------BBBBB--o--------------------------------------Xo------o--------------B---------------?--------------------------o----------------------X---v---------
----------------------------X------------------------------------------------------------------------------------X--------------------o----------------------------------------------------------------f---------
----------------------------------------------------------X-------X------------------------------------------------------------------------------------T------------------------------X----B---------o-f---------
---o--------------------------X------------------------------------------o--------------------------------------X--------------------------------------|--------o-o--------o---------------------------f---------
----------------o---------XBBXBBBB-------------------BX-BXB-B?BBB--?---BBBBBB-?-XXXXXXX---------------BBXXB---BBB----------------oB-------------------?|-??------?--------------------o----------------f---------
---------o----------------------------------o--------------------------------o---------o-----------------------o---------------------------------------|----------------------------B------------------f---------
-----------------------------------------------------------------------------?----------------------o----------------------------------o----------X----|-------------------X---------------------------f---------
m-E------------------------------------------------E-------E--------------------------------------E---------E------------------------------------------|----------------E------------------------------X---------
XXXXXXXXXXXXXXXXXXXXXXXXXXXXXXXXXXXXXXXXXXXXXXXXXXXXXXXXXXXXXXXXXXXXXXXXXXXXXXXXXXXXXXXXXXXXXXXXXXXXXXXXXXXXXXXXXXXXXXXXXXXXXXXXXXXXXXXXXXXXXXXXXXXXXXXXXXXXXXXXXXXXXXXXXXXXXXXXXXXXXXXXXXXXXXXXXXXXXXXXXXXXXXXXX
