-----------------------------------------------------------------------------------------------------------------------------------------------------------------------------------------------------------
--------------------------------------------o--------o-----------------------------------------------------------------------------------------------------------------------------------------------------
--------------------------?------------------------------------------------X--------------------------------------------------------o----------------------------------------------------------------------
--------------------------------------------------X--BBX----------------------------------------------------------------------o--------------------------B-------------------------------------------------
------------------o-o------------------o---------------?--------o-----------------o-------------------------------------------------------------------------------------o----------------------------------
-------------------------------------------------------------------X---------o----------------------------------------------------------------------------E------------------------------------------------
---------------X-----------------------------------------X---------------------------------------------------?-----B--------o----------------o-------BBBB-B---------B--------------------------------------
-----------------X-----------------------------------???-----------?X?????---?---------------------BB------o--------X---------------------X---------------------------X------------X-------------------v---
--o-----------------B--------------X----------------------------------------------------BBB------------------------------------------------------------------------------------X-----B-----------------f---
--------------------T-------------------------------------------------o------------B?BBB-------------------------------BBBBB-----------------------BBB----T----------------------------------X---------f---
--------------o-----|---------------T--T--o---------------------------------------------------------------------------------------------------------------|--------------------------------------------f---
-------------------B|BBBB-XXXXX-----|--|--BBXBBBBX?BBBBXB-------XXXXX-----------????--BBBB-------BXBB--T---BBB--BXBBBBBBBXBBBB----BBBB------------BBB-B-oB|BBB----X-------------------------X----------f---
--------------------|--------------T|--|------------------------------o--------------------------------|-------o--o---------------------------o-----------|---------------------------------o----------f---
---oo---------------|--------------||--|---------------------?-----------------------------------------|-------X------------------------------------------|--------------------------------------------f---
m-------------------|-E-------E----||--|---------------------------------------------------------------|--------------------o-----------------------------|-----------------------E----------------E---X---
XXXXXXXXXXXXXXXXXXXXXXXXXXXXXXXXXXXXXXXXXXXXXXXXXXXXXXXXXXXXXXXXXXXXXXXXXXXXXXXXXXXXXXXXXXXXXXXXXXXXXXXXXXXXXXXXXXXXXXXXXXXXXXXXXXXXXXXXXXXXXXXXXXXXXXXXXXXXXXXXXXXXXXXXXXXXXXXXXXXXXXXXXXXXXXXXXXXXXXXXXXX
