-----------------------------------------------------------------------------------------------------------------------------------------------------------------------------------------------------------
-------------------------------------------------------------------------------------o-------------------?----------------------------------------------?-------------------------o----------------o-------
---o-------------------------------------------------------------------------------------------------------?-----------------------------------------------------------------------------------------------
------------------------------------------------?--------------o------------------------------------------------------------------------------------------------------------------o------------------------
--------o--------------------------o------------o-----------o--------------o-----X-------?-----------------------------------------------------------------------------------------------------------------
------------------------------------------------o-----X-----------o---------------------------------o---------?-----------------------o--------------------------------------X-----------------------------
--------------------------X---------X---------------------------------------B--------------------------------------------?---------------------------------------------------------------------------------
--------?---------------------------------------------XXXXX------------------------B--------------X-------------------X--------------------------------------------------------------------------------v---
--------------------------X-----------X-----------------------T---------------------------XXXX---------------------------------------------------------------------------------------------------------f---
----------------------------------------------------XXX-------|--------------------------------------------------------------o------------------------XXX-X----------------------?---------------------f---
-------------------------------------o--------------o-------o-|-----------------T--------------------o----------------------------o----------------------X-------o-------------------------------------f---
----------------------o--------------XXX------------XXX----XXX|--o-XXXXXXXX-XXX-|---XXXXXXX---XXXX-------?---------XXX-----XXXXX---XXXXXXXX------XXXXX------------o-----B------------------?-----------f---
-----------------o----------o---------------------------------|--o---------oo---|------o-----------T---o--------------------------------T-------------------------------------------------------------of---
--------------------------------------------------------------|----o------------|------------------|------------------------------------|--------------------------------------------------------------f---
m-E---------------------------------------------E-------------|-----------------|------------------|---------E--------------------------|---E------------------------E---------------------------------X---
XXXXXXXXXXXXXXXXXXXXXXXXXXXXXXXXXXXXXXXXXXXXXXXXXXXXXXXXXXXXXXXXXXXXXXXXXXXXXXXXXXXXXXXXXXXXXXXXXXXXXXXXXXXXXXXXXXXXXXXXXXXXXXXXXXXXXXXXXXXXXXXXXXXXXXXXXXXXXXXXXXXXXXXXXXXXXXXXXXXXXXXXXXXXXXXXXXXXXXXXXXX
