-----------------------------------------------------------------------------------------------------------------------------------------------------------------------------------------------------------
------------------------------o-----------------o------------------------------------------------------------------------------------o----------------------------------o----------------------------------
-----------------------------------------------------?----------------------------------------------------------o----BBB---------------o-------------------------------------------------------------------
--------------------------------------------o--------------------BBB-o------------------------------------------?----------------o------------------------------------------X------------------------------
------------------------X-------------------------------------------E-------------XXXXXX------------------------------------------------------------------------------X------------------------------------
---X----------X-----B---------BBB--------------XXXX--------------XXXX-----o----BBB-o----------------BBBBX---------o-o---------------BBXo-------X---B--------------------------B-------o-X------------------
------------------------------------------------------o--?------------------------------------------------------BBBBBBXB----------o-------------------------------XX?XX--o--------------o------------------
------------------------------BBBBBBB-------XXXX----B-----------BBBB-----------B?BBBBBBX---o---o-XXXX-o--BBBB--------------?X?X----------------------oBBBB------------------------------------X--------v---
----------------------o----B------------------------------------------o--------E------------------------o----------------------------------------------------------------XXXXXXXX----------------------f---
-----------------------------------------------TBBB---------B-BBBBB?X-XX-----BXB-------o-----------------BBBXBB-B---oBBB------BB---X?BBBBBB---o---B-----------XBBBBXBB---------------------------------f---
-------------E-E--------------o---------------E|--------------------E------E--------o---------------------------------o--------------------------------------X----------------o------------------X-----f---
-----------BBBBB-------------BBBBB-----XBBBBX-B|BBBBB----?B?????-BBBBBXXX-BXBBB--BBBBXBBBBBXBTBBBX-----BBXBBXB-----BB-??--BBBBB---BB----TBBBB?-T--X--BBBBB?Xo-BBTB----BXBXB------------o---------------f---
-----------------------------------------------|----------------------------o----------------|------------------------------------------|------|---------X-----o|-----------------X---X----------------f---
----------------------o------o-----------------|---------------------------------------------|---------------o--o-----------------------|------|----------------|-----------o------------o------------of---
m-E------E---E-E-E------E--------EE-----E----E-|----E-E---E----E------EE-------E-E-----E-----|-------E---E--------------E--E------------|-E----|----------E-E---|----------------E-----E---------------X---
XXXXXXXXXXXXXXXXXXXXXXXXXXXXXXXXXXXXXXXXXXXXXXXXXXXXXXXXXXXXXXXXXXXXXXXXXXXXXXXXXXXXXXXXXXXXXXXXXXXXXXXXXXXXXXXXXXXXXXXXXXXXXXXXXXXXXXXXXXXXXXXXXXXXXXXXXXXXXXXXXXXXXXXXXXXXXXXXXXXXXXXXXXXXXXXXXXXXXXXXXXX
