-----------------------------------------------------------------------------------------------------------------------------------------------------------------------------------------------------------
---------------------------------------------------------------------------------------------------------------------X-------------------------------------------------------------------------------------
----------------------------------------------------------------------------------o-----------------------------X------------------------------------------------------------------------------------------
--------------------------------------------------------------------o--------------------------------------------------------------------------------------------------------------------------------------
--------------------------------------------------------------Xo-------------------------------------------------------------------------------------------------------o-----------------------------------
----------------------o--------------------------------------------------------------------------------------------------------------------------------------------------------------------------o---------
--------------------------------------------------------------------------------------------------------------------X--------------------------------------------------------------------------------------
------------------------------------o-------------------B-------------------------o---------------------------------------o-----------------------------------------------------------------------o----v---
---------------------------X----------------------------???????------------------------------------------------------------XXXX----X------BBBB---XX-----------T----------------------------------------f---
----------------------------o----------------X------------------XXX---------o-XXXXXX--------------------------------------------------------------------o-----|----------------------------------------f---
---------------------------------------------------------XXXX-------------XXXX-------------------------------------------------------T------------------------|----------------------------------------f---
-------------------------------T---------------------------------------XXXXXXX-------------------------------------------------------|-------XXXXX---XXXXXX---|----------------------------------------f---
---------o---------------------|-------------------------------------------X--------------------XXXXXXX--------XXXXX-----------------|-------------------X-X-X|----------------------------------------f---
--------------X----------------|------------------------------------------------------------------o------------------------------XX--|------------------------|----------------------------------------f---
m------------------------------|----E-----------E--------------E------------------------------o-------------------------------E------|------------------------|---------E------------------------------X---
XXXXXXXXXXXXXXXXXXXXXXXXXXXXXXXXXXXXXXXXXXXXXXXXXXXXXXXXXXXXXXXXXXXXXXXXXXXXXXXXXXXXXXXXXXXXXXXXXXXXXXXXXXXXXXXXXXXXXXXXXXXXXXXXXXXXXXXXXXXXXXXXXXXXXXXXXXXXXXXXXXXXXXXXXXXXXXXXXXXXXXXXXXXXXXXXXXXXXXXXXXX
