--------------------------------------------------------------------------------------------------------------------------------------------------------------------------------------------------------
----------------------------------------------o---------------------?-----------------------------------------------------------------------------------------------------------------------------------
-o------------------------------------------------------------------------------------------------------------------------------------------------------------------------------------------------------
---------------------------B-------------------------------------------------X------------o--------------------------------------?----------------------------------------------------------------------
--------------------------------------------------------------------------------------------------------------------------------------------------------------------------------------------------------
--------------------------------------------------------------------------------------------------------------------------------------------------------------------------------------------------------
-----------------------------------------------------o---------------o----------------------------------------------------------------------------------------------------------------------------------
--------------------------------------------------------------------------------------------------------------------------------------------------------------------X--------o-------------------------v
-------------------------------------------------------------------------------------------XXXXXXX--------------XXXXXXXX-X--------------------------------X----XXXXXX----------------------------------f
---------------------------------XXXXX-----------------------------o------XXX---------------------------------------------------XXXX----------------------B--------------------------o-----------------f
-------------------o------------------------------------------------------------------XXX-----------------------------------------------------T-------------------o------------------------------------f
-------------------------------o----------------------------XXXX------------------------------------------------XXXXXXXX----------------------|-------------X------------------------------------------f
------------------------------------T----B---------------------T------------------------------------------T------------X----------------------|--------------------------------------------------------f
--?---------------------------------|--------------------------|----------XXXXXXX-------XXXX--------------|------------------????????-XXX-----|--------------------------------------------------------f
m--------E--------------------------|---E-------E--E-----------|-------------E----------------------------|---E-------------------------------|----------------------------E---------------------------X
XXXXXXXXXXXXXXXXXXXXXXXXXXXXXXXXXXXXXXXXXXXXXXXXXXXXXXXXXXXXXXXXXXXXXXXXXXXXXXXXXXXXXXXXXXXXXXXXXXXXXXXXXXXXXXXXXXXXXXXXXXXXXXXXXXXXXXXXXXXXXXXXXXXXXXXXXXXXXXXXXXXXXXXXXXXXXXXXXXXXXXXXXXXXXXXXXXXXXXXX
