-----------------------------------------------------------------------------------------------------------------------------------------------------------------------------------------------------------
----------------------------------------------------------------------------------------------------------------------------------------------------------------------------o------------------------------
------------o-----------------------------------------------------------------------------------------------------------------o--------XX-XX-------------------X------------------------------------X------
----------------------------------------------------o------------------------------X--------------------o-------------------------------------------------------------------o-------X----------------------
------------------------------------------------------------------------------o----------------------------------------------------------------------------------------------------------------------------
---------------------------------------------------------------XBB-------------------------BBBBBBB?----------------------------X----------------------------------------o----------------------------------
--------------------o----------------------------------BBBBBBB-------------------------------------------B--------------------------BXBXBBBB---------------------------------------------------------------
-----------------------?---------XBB-------------BBXBB--------????-----------------------o-BBB--------o----------------BB---------------------------?---------B----------------------------------------v---
----o-------------------------------------------T------BXBB---------------------------------------------------------------------------------------------------------o-----------------------o----------f---
------------B-----------------------------------|-----------------------------BBBBBBB---BBBBBBT---------T-----------------------o---??????--------------------------------B----------------------------f---
------------------------------------------------|-------------------------T--------------T----|---------|------------------------------------------------------------------o---------------------------f---
----o------------------------BX--XXXX---------BB|B---BBBB---BBB----T---XX?|BBBBBB-------B|BBBB|B---BBBBB|BBBBB---------BB----XX???X??--X---------------XXX--????BBBBB----------?-----------X--------o--f---
---------------X----------o---------------------|o-----------------|------|--------------|----|---------|----------------------B-----------------------------------------------o-----------------------f---
-------------------------------------X-o--------|----------o-------|------|--------------|----|---------|------------------------------------------------o-----------------------------------?---------f---
m--------------------------------E--------------|----EE------------|------|-E------------|----|---------|--------------------------------o-------------------------------------------------------------X---
XXXXXXXXXXXXXXXXXXXXXXXXXXXXXXXXXXXXXXXXXXXXXXXXXXXXXXXXXXXXXXXXXXXXXXXXXXXXXXXXXXXXXXXXXXXXXXXXXXXXXXXXXXXXXXXXXXXXXXXXXXXXXXXXXXXXXXXXXXXXXXXXXXXXXXXXXXXXXXXXXXXXXXXXXXXXXXXXXXXXXXXXXXXXXXXXXXXXXXXXXXX
