--------------------------------------------------------------------------------------------------------------------------------------------------------------------------------------------------------------
------------------------------------------------------------------------o-----------------o---------------------------------X------------o--------o-----------------------------------------------------------
----------------------------o-----------------------------------------------------------------o---------------------------------------------------------------o-----------------------------------------------
------------------o--------------------------------------------------o-------o---------------o--------------o----------------------------------------o--------------------------------------------------------
-o--------------------------------------------------o----------o---oo-------------------o----------------------------------------------------------------------B-------------------------------o--------------
-o---------X----------------X------------------------------------------X--------------------X--------------------B-----??X?---------X-----------------X-----o-------XX--------------------------------B-------
-------------------B------------------------X-----------------------------------------------------------------o------------------------------o------------X---------------------------------------------------
--o----------------X-------------X--------------X-------------?-------X---------------------------X------o--------BBB------------------------------------------------o--------------X------------------v------
-----------------------------BBB---------------------X----------------------------------B-----------------------------XXXX---------o------?-----------T---------------------o--------------o----o------f------
------------------------------------------X---------------------------o---------------------------------------------------------------------------o---|----------------------------X-------------------f------
-------------------------------------o------------------o---------------------------------------------------------------------------------------------|--------------X------------------------Xo-------f------
--o---------X--------XXXXXXX-?BBBBB?------XBBB------BBB-BXBBB------o-----XBBBBBB-----BXBBBB--------T-------------X????X-------BBBXBBBB------------?X??|B?-------------o---------------o----------------f------
-----------o------------------o---------------o----------------------------------------------------|------------T------------------------------------o|---o-------------------------B------------------f------
-------------------o---------X--------------------------------------o------------------o----o------|------------|----------------------X--------------|-------------------------o----------------------f------
m--------E---------E-------------------------------------------------------------------------------|------------|-------------------------------------|-----------------E-----------------------------EX------
XXXXXXXXXXXXXXXXXXXXXXXXXXXXXXXXXXXXXXXXXXXXXXXXXXXXXXXXXXXXXXXXXXXXXXXXXXXXXXXXXXXXXXXXXXXXXXXXXXXXXXXXXXXXXXXXXXXXXXXXXXXXXXXXXXXXXXXXXXXXXXXXXXXXXXXXXXXXXXXXXXXXXXXXXXXXXXXXXXXXXXXXXXXXXXXXXXXXXXXXXXXXXX
