-----------------------------------------------------------------------------------------------------------------------------------------------------------------------------------------------------------
-----------------------------------------------------------------------------------------------------------------------------------------------------------------------------------------------------------
-----------------------------------------------------------------------------------------------------------------------------------------------------------------------------------------------------------
------------------------------------------------------------------------------------o----------------------------------------------------------------------------------------------------------------------
---------------------------------------------------------------------------B-------------------------------------------------------------------------------------------------------------------------------
------------------------------o--------------------------------------------------------------------------o-----------------------------------------------------------------------------------------X-------
---------------------------------------------------------------?-------------------------------------------------------------o-----------------X-----------------------------------------------------------
------------------------?------------------------------------------------------------------------------------------------------------------------------------------------------------------------------v---
------------XXXX-----------------X----E-----------------------------------------XXXXXX-------------------------------------------XXXXX---------BBBBBBBBo-----------------------------------------------f---
------------XXXXXX--------------------XXXXXXXX------XXXXX-----------------------X--------------------BXXXXXX------------???????------------------------------------------------------------------------f---
-------------------------o------------------------------------------------------------------------------------BBBBBBB---XXXXXXX------------------------XXXX--------------------------------------------f---
---------------------------------------------------------------------------------------------------------------BBBBBBB-???????o------------------------------------------------------------------------f---
--------------------------------------TT-XXX----------------------------------------------------------T---------------------------------------------------------------------o--------------------------f---
--------------------------------------||--------------------------------------------------------------|--------------------XXXXXXXX----------------------------o---------------------------------------f---
m----------------E--------------------||--------------------------------------------------------------|-----------------------------------E--------------EE--------------------------------------------X---
XXXXXXXXXXXXXXXXXXXXXXXXXXXXXXXXXXXXXXXXXXXXXXXXXXXXXXXXXXXXXXXXXXXXXXXXXXXXXXXXXXXXXXXXXXXXXXXXXXXXXXXXXXXXXXXXXXXXXXXXXXXXXXXXXXXXXXXXXXXXXXXXXXXXXXXXXXXXXXXXXXXXXXXXXXXXXXXXXXXXXXXXXXXXXXXXXXXXXXXXXXX
