-----------------------------------------------------------------------------------------------------------------------------------------------------------------------------------------------------------
------------------------------o------------------------X-----o--o-o-------------o---X-----------------------------------------------------------------------------------o----------------------------------
---------------------------------------------------o------------------------------------------BBBBBBBBBB----------BBBBBB-----------------------------------------------------------------------------------
---o-------------------------------------------------------------BBB-------------------------------------------------------------o-------------------------------------------------------X-----------------
------------------------X----------------------X-----BBB------------E-----o----------E---------------------o---------------------------X-----o------------------------X------------------------------------
---X----------X-----B---------BBB----------------------o----BBB--XXXXX---------BBBBBBB------------------BBBB-X----------------------BBBo---------?-B--------------------------B------X---------------------
----------------------------------------------------o---------------------------------------BBBBBBBBo---------BBBBB--BXB------------------------------------------XX?XX-----------------o------------------
------------------------------BBBBBBB-------------B?BB-----------B?B-----------BBBBB---------------------------------------????----------------------oBBBB---------------------------------------------v---
----------------------------------------------------o--------------------------E----------------------------oXBB--------------------o------------------------------------XXXXXXXX-----o-X--------------f---
--------------------------------------?-----------T------XXXXXXX-BBB--------??BB------BBBBBBBB----------XXXX----o----BBB------BB---B?BBBBBB---o---B-----------BBBXBX-B-o-------------------------------f---
---o---------E-E----------------------------------|-----------------E----------------E---------------o---------oo-------------------------------------------oX-----------------------------------------f---
-----------BBBBB-------------?BBBB-----XBBXB-BBXBB|BB--BBBB------BBBBB----BBBBB--BBB-BBBBBBXo---------BB--B?BB?-----????--BBBBB--BBB----TBBBBB-T--X--B-BBXX?--BBTB----BXBBB---------o------------------f---
-------------------o------------------------------|------------------------------------o-----T--X---o--o-------------------------o------|------|---------------o|-----------------X--------------------f---
----------------------o------o-o----------------X-|---------------------------o--o-----------|------------------------------------------|------|----------------|------------------------------------o-f---
m-E------E---E-E-E------E--------EE-----E----E-E-E|E--E------------------------E-EE-EE---EE--|---E---EE-------E---E-----E--E------------|-E----|----------E-E---|----------------E-----E---------------X---
XXXXXXXXXXXXXXXXXXXXXXXXXXXXXXXXXXXXXXXXXXXXXXXXXXXXXXXXXXXXXXXXXXXXXXXXXXXXXXXXXXXXXXXXXXXXXXXXXXXXXXXXXXXXXXXXXXXXXXXXXXXXXXXXXXXXXXXXXXXXXXXXXXXXXXXXXXXXXXXXXXXXXXXXXXXXXXXXXXXXXXXXXXXXXXXXXXXXXXXXXXX
