-----------------------------------------------------------------------------------------------------------------------------------------------------------------------------------------------------------
-------------------------------------------------X--------o---o-----------------------------o-----------------------------------BBB-----X-------------X-------------------X--------------------------------
---?----------------X-X---------------------o-----------------------o-----------------o---?----------------------------------------------------------------------------------------------------------------
----------------------------------------------------------------------------------------------o------------------------------------------------------------------------------------------------------------
---------------------o----o---------------B-----------o--------------------------------o--------------------------------?----------------BBBBBBBB----------------------------------------------------------
-----------?-------B-------------------------------------------------------------------BBB--------------------------------------BBBBB---------------o------------------------X-----------------------------
-------------------------o------------------------X---------------------------------o------------------------------------------o---------------------------------------------------------------------------
---------------------------X----------------------------------------------------------XXX-XX--------BB-BB-------------------------------------------------------X-------------o------------------------v---
-------o-----------------------------------------------------------?BBX-o--------------------------------BB------BBBX----------BBBBB---BBB------o-----------------------X-----X------------------------f---
--------------------------X--------B--o---B-BBBB-------oX--------------------------------------------------------------------------------------------------------------o-------------------------------f---
-------------------o-------------------------------T-----------------------X------T-----E------------------?-------------------------------------------------------------------------------------------f---
--------------B-BBBX-------BXXX-BX---o---B---------|-------TT--BB-----o----BTBB-?-|----BBB--------XTX--X-X-B--B-BBBBXXBB-B?BBBBBBB---BBBB--------------------------BBBBB-------------------------------f---
-------------?---------------------------------o---|-------||T--------------|-----|-----T----------|--T-------------------------------------T---------T-o---------------------------oo-----------------f---
-------------------o-------------------------------|-------|||--------------|-----|-----|-----o----|--|---------o---------------------------|---?-----|------------------------------------------------f---
m--------------------------------------------E-----|-------|||--------------|-----|-----|---E------|--|-------------------------------------|--E------|---------------------E-----E--------------------X---
XXXXXXXXXXXXXXXXXXXXXXXXXXXXXXXXXXXXXXXXXXXXXXXXXXXXXXXXXXXXXXXXXXXXXXXXXXXXXXXXXXXXXXXXXXXXXXXXXXXXXXXXXXXXXXXXXXXXXXXXXXXXXXXXXXXXXXXXXXXXXXXXXXXXXXXXXXXXXXXXXXXXXXXXXXXXXXXXXXXXXXXXXXXXXXXXXXXXXXXXXXX
