-----------------------------------------------------------------------------------------------------------------------------------------------------------------------------------------------------------
-------------o------?-------------------?------------------------------------------------o------------------------------------------X----------------------------------------------------------------------
------------------------------------------------------------------------------------------------------------------XBXXBBBB---------------------------------------------------------------------------------
-----------o----------o---------o-------------------------------------------------------------------------------------------------------------------------------------------------o------------------------
-------------------------------------------------------------------------------E---------X-------------------BBBBBB---X--------------------X---------------------------------------------------------------
--------Bo------------------o---------------------------o--BBB----------BB--B-BB-------o--------------------------------------------------------o--B-------------------------------------------------------
---------------------------------------------------------------------------------o--o----------------------BBBBBBB---------------------------------------BBBB--------B-----B--X----------------------------
---------------oX-o----------------------------------BBX-B-BB-----------o---------?-------------X--------------------------------o-----------o------------o--------------------------------------------v---
----------------------------------------To----------T-------------------------------------BB?BBX--------??X??--------------------------------------BBBBBBBB--------------------------------------------f---
----------------------------------------|-----------|--------------T-----BBBBBB------------------o-------------------------------------------------------------------XBBB------------------------------f---
----------------------------------------|-----------|--------------|-------------------T--------------------T----------------------------o-------T-----------------------------------------------------f---
-----------BBBBBBBB---BBBBBBXXXX---BBBBB|------BBB-B|B-B-------TT??|?---X-XX-----------|BXBBBT-BB-X????-???-|------------------BBB-------T-BBB---|XBBBBB--------BBBBBBB--------------------B--X--------f---
-------------------------------------ooo|-----------|----------||--|-------------------|-----|--------------|---T-T-----------T---o------|-------|---T------------------------------o------------------f---
----------------------------------------|-----------|----------||--|-------------------|-----|-----?--------|---|-|-o?--------|----------|-------|---|-----------------------------------o-------------f---
m---------------------------------------|-----------|----------||--|----------------E--|-----|E-------------|---|-|---E-------|----------|-------|---|---------E---E------------------E------------E---X---
XXXXXXXXXXXXXXXXXXXXXXXXXXXXXXXXXXXXXXXXXXXXXXXXXXXXXXXXXXXXXXXXXXXXXXXXXXXXXXXXXXXXXXXXXXXXXXXXXXXXXXXXXXXXXXXXXXXXXXXXXXXXXXXXXXXXXXXXXXXXXXXXXXXXXXXXXXXXXXXXXXXXXXXXXXXXXXXXXXXXXXXXXXXXXXXXXXXXXXXXXXX
