--------------------------------------------------------------------------------------------------------------------------------------------------------------------------------------------------------------
-------------B---------------------B------------------------o----------------------------o-------------------------------------------------o------o-----------------------------------------------o-----------
------------------------------------------------------------------------------X-------------------------X------------------------------------X-----------X-------------------------------------X---o-o--------
---X----------------------------------------------------------------------------------------------------------------o-----------------------------------------------------------------------------------------
------------o-------------------o------------------X------o-------X---------B-----------------------------?-----------X---------------------------------------------------------------------------------------
-----------------------X------------------X------------------------X--------------X-X--------------------------X-----------------------X-----------------?X?X-------------------------------------------------
-------------o----------------------------------------------------------------------------------o-------------o--oo-----------o------o-----------------o-------------o-?--------------------------------------
----------------------B----------------------------------------------------XBo--------o--------------------------------------------------------------BBBBBBX--------------------------X---------------ov------
-------X---------?---------------o-------X--------------------------X----------------------o----------------------BBBBBBBB---X--------------------------o----------o-----o-----------------------------f------
----------------------------------------------o???X------BBBBBBB--------------------------------------BBBBXB----------------------B-------------------------------------------------?-----X------------f------
--------------------------B-------------------X--------------------------------T------------------------------------------------X---T-o------T-------------------------------------o------------X------f------
--------------------XBB--------XBXB-XBX--------BBB-----B?B-----XBBB----T---BBBX|-???B----------BBB-XX-X--------????-----------------|------T-|-???-XX??---BBXBBB---------------------------------------f------
------------o--------------o-------------------------------------------|-------T-------T------T----o---------------T----------------|------|-|---------------------------------------------------------f------
-----------------------------------------------------------------------|-------|---?---|------|-o------------------|----o-----------|------|-|-------------------------------------------o-----X----o--f------
m----E-----------------------------E-----------------------------------|-------|------E|------|-------------E------|----------------|------|-|------------------------------------------------E--------X------
XXXXXXXXXXXXXXXXXXXXXXXXXXXXXXXXXXXXXXXXXXXXXXXXXXXXXXXXXXXXXXXXXXXXXXXXXXXXXXXXXXXXXXXXXXXXXXXXXXXXXXXXXXXXXXXXXXXXXXXXXXXXXXXXXXXXXXXXXXXXXXXXXXXXXXXXXXXXXXXXXXXXXXXXXXXXXXXXXXXXXXXXXXXXXXXXXXXXXXXXXXXXXX
