-----------------------------------------------------------------------------------------------------------------------------------------------------------------------------------------------------------
--------------------------o---------X-----------------------------------------o----------------------------------------------------------------------------------------------------------oB----------------
-X--------------------------------X------------------------o-----------------------------------------?----------------------------X------------?-----o------X-------o--------------------o-----------------
----------------------------------o-?---------------------------------------------------------------------o---o--------------------X--B-----------------------o-----------------------o--------------------
---------------------------------------------------------o------------------------------------X-----------------------o----------------------------------------------------------------o-------X-----------
------X---------------------------------------------------X------------?--------B----------B--------------------------------------------o------------------------------------------------------------------
------?------------------------------------------------------------------------------------B-----------------------------X------------------------o-----------X------------------------o-------------------
----o----------o------XB-------------------?-o----X------------X----------------------------------B---------------------------------------X-----------------------------------------X------------------v---
----------------------------------------o-------------X--------------------------X---------------------------------------------T-------------------------------------------X---o-----------------------f---
----------------------------------------------------X------o------------------------------------------------------------------o|o--X-------------------------------------------------------------------f---
------------o--------------------o---?-------------------o------------------------------?----------------------o-X-------------|-o---------------------------B-----------------------------------------f---
------------B--X---------T------------------------------------------------------------------------X----------------X------o--T-|------o---------------------------------?-----o----B----------X--------f---
----------------o--------|---------------------------o-T----------------------------------------------------------------T--o-|-|--o--------oX-----X--------o---T---------------------------X------o----f---
-----o-o--------?--------|-------o---------------------|----------------------------------o------------------------o----|----|-|---------------------o---------|---------o-o---------------------------f---
m-o----E-----------------|-----------------------------|-----------------E--------------------------------------E-------|----|-|--------------------------o----|---------------------------------------X---
XXXXXXXXXXXXXXXXXXXXXXXXXXXXXXXXXXXXXXXXXXXXXXXXXXXXXXXXXXXXXXXXXXXXXXXXXXXXXXXXXXXXXXXXXXXXXXXXXXXXXXXXXXXXXXXXXXXXXXXXXXXXXXXXXXXXXXXXXXXXXXXXXXXXXXXXXXXXXXXXXXXXXXXXXXXXXXXXXXXXXXXXXXXXXXXXXXXXXXXXXXX
