-ME--?-|X------------------Xo----?T-Bo------|X--------T-B----T----M------|-----B------------B|-T---|T--EoE------|T----|o|o--?--|----------?E---B-------T---T-X?-----|--------|-X-E-Bo---B---|T------T---
------------------o-oM--------MX-----o-BM|X?---M---?E------E----?oM------M-------X|------T|-T-------E--BMB-?-o-----T?-o------TX--------------E-T?--------E-B?--?-----T-----------------------------T----
----E--B-----B----M---------B-||-M----E-B-X----------o----o-B----B--B-|-MX---|--|-------------M--o-----M|-----|--X---------MT------TMT|?-----o-?-ME----------T--X----MM--X-E----?-----?X----M-|-?-------
-----X-o-----T--M--T------|----E--XB---------E---M-------------Eo--B-E-------M--M------TX---T----o---E------------------------TT-MM-o------------T---------T-----T------------|-M--X---B----B----|--oM--
-------B--------o|-E---M--ME-?--|------E--|----E-?-E-E-----|-------?-|---X---o--X-X-B---o-M----------E--E--------X--?--------?|M----o-o-----BE-------------------B-----------------------------o-?o--M--
------------------|-EE-----------|-B-To--------B----B--------------------?---------E---E-X---Xo---M|-?-M-----T---------M---|T----|----?B|-----------?--|--|-o----E--|-----------TB-------------?-|--o---
-----B--|------------oo--------oT--o?----X---------B--------E-B--BE----EBMX--M-----------T-X-----------------X--?---M-----T-------E--BMEEoo-----?TE-------------o-----------X---o-----B-----------M--|--
-M-M---M-E--B-----------|------B---|-----o--T---|--o-B|B-XoB|--M--?----o--------X----E---|-E-MB------T--XT--B----M--o-oB-?-B?ToTBX-?-------o--?Mo-o-?----X-------T----T----X-|-------?X-T----------B---v
---X-|-----------?----o-----M--M--Mo-o-------------T-----------?---o----?|?-|--E-X---X-o---XX---|-------|--------------oE-------M-|---E-|--------|MB--B-M----------EMo-B--|--------TM--B-TB-------E--||f
--E------M----|------T-ME----E------?E--------BXX--------B--T--o-E---M|--?---E--------------X---|-------------X------------o--B--E-|-T-E-|--T-----?---------------------------E-T----o-E-B-X--M-M--|B--f
----o---|--TM---------T--oX----------------------Mo-?-|--X----------|---B--XX----M-----------o---------E--?--o---E--B--o----T---B------|--EE--EEB---B--?oB------X|--X--?------------?------E-----------f
------?------B---E-----T-oME-----oB-----oo---oo-oEE--|---X--E-----?-o--X--E--T-------M--?----|-----E-E-----B-----M----oo----X------|----o-T--?-----X-----?-------XM--o----?|-M--E----E-B-M--?--X----E--f
-o-----o?-M------E--B---BB----B-------o---|--B?--E-----------X-----------------|-M------T-------T----|-EX---------BB--?---E-------|-BoTE---E--X-E----o-o-|-X--B|-T-EX------B----E-------------X-|||--E-f
-----------------T---T-B------------|---M--|-----X-----o-----o-------------|--o---------------B--?----X--|B------?--BX-X----E-X-T?X--M-----o-------TB-X--|T---------B-M-|----?-----B---?-T-MBBo-M-?----f
m------------------------------------------------------------------------------------------------------------------------------------------------------------------------------------------------------X
XXXXXXXXXXXXXXXXXXXXXXXXXXXXXXXXXXXXXXXXXXXXXXXXXXXXXXXXXXXXXXXXXXXXXXXXXXXXXXXXXXXXXXXXXXXXXXXXXXXXXXXXXXXXXXXXXXXXXXXXXXXXXXXXXXXXXXXXXXXXXXXXXXXXXXXXXXXXXXXXXXXXXXXXXXXXXXXXXXXXXXXXXXXXXXXXXXXXXXXX
