-----------------------------------------------------------------------------------------------------------------------------------------------------------------------------------------------------------
------------------------X---------------------------------Xo-----o---------------X--------o----------------------------------------------o-----------------------------------------------------------o-----
------------------------------------------------------------o---------------------------------------------------------------------------o------------------------------------------------------------------
--------------------------------------------o----------------------------------o--------------------------X------------------------------------------------------------------------------------------------
----------------------------------------o------------o------------------oo--------------X---------------B--------------------------X------------o----------------------------------------------------------
-------------?----------X------------------X---X-------------------------------------------------B---------o--------------X------------------------------------------------------X---B---------------------
---------------X-------------------------------------------------------------------------------------------o-----------------o---------------------------------------X---------o---------------------------
---?--------------------------------------------------------------------------o---------------------X-BBB------------------------------------------oX----------------------------------------------o---v---
------------------------------------------------X------------------B------------------------------------o-----------------o------------X---------------------o--------X-------o-------------------o----f---
---X-------------------------------------------------------------------o---------------------?---------------------------X---------------------------------------------------X-------------B-----------f---
--------o------X-----------------------------------------------------------------------T------o----X-------o-----------T----------T--------------------T------------------------------------o----------f---
--------X---------?BXXB---------T--------------BB-------------XXXXX---T---o-----o-----B|-----------BBBBBB-BB-BXB?---BBB|--BXBB----|o---T-----X---------|-------------------------------o-o------------of---
-oo-----------------------------|------------------X------------------|----------------|--------------------T--------T-|---------TT-T--|----T------T--T|------T--BX-o---------o------------?-----------f---
---------------o----------------|----------------------------------X--|----o-----------|--------------------|--------|-|--B-----o||-|--|----|o-----|--||------|----------------------------------------f---
m------------------E------------|-------------------------------------|----------E-----|--------------------|-E------|-|--------E||-|--|----|------|--||------|---------------------E-E----------------X---
XXXXXXXXXXXXXXXXXXXXXXXXXXXXXXXXXXXXXXXXXXXXXXXXXXXXXXXXXXXXXXXXXXXXXXXXXXXXXXXXXXXXXXXXXXXXXXXXXXXXXXXXXXXXXXXXXXXXXXXXXXXXXXXXXXXXXXXXXXXXXXXXXXXXXXXXXXXXXXXXXXXXXXXXXXXXXXXXXXXXXXXXXXXXXXXXXXXXXXXXXXX
