-----------------------------------------------------------------------------------------------------------------------------------------------------------------------------------------------------------
---------------------------------------------------------o-------------------------------------------------------o----------------------------------------o-----------------------o------------------------
---o----------------------------------------------o---------------------------X---------------------------------------------------------------------------------------------------------X------------------
---------------------------------------o-----------------------------------------------------------------o-o-----------------------------------------------------------------------------------------------
------------------------------------------------B-------------------o--------------------------------------------------------------------------------------------------------------------------------------
------------------------------------------------------X--------------------------------------------------------------------------------------o----------X------------------------------------------o-------
---------------------------o---------------------------------------------o--------------------------------X------------o-----------------------------------------?-------------------X---------------------
--------?------------------------------------------------------------o-----------XXX-------B------------o---o---------------------------X--------------------------------------------------------------v---
----------------------------------------------------------?-XXX-----------------------------------------------------X-----------X--------------------------B--B-----------------B----------------------f---
----------------------------------------------------------------------XX-------o---------------------------X-------------------------o-------------------o-----------------------?---------------------f---
---------------------------------------------------------------------o-----------------------------------------------o------------------o--------------------------------------------------------------f---
--------------------o-o-------XXXXXXX-------XXXX-X--------------XXXXX-X-XX------XXX-----???B?-o-----------XXXXXX--?--------XXXX-X--------X-----XXX-B-o------------------B------------------?-----------f---
-----------------o--------------------------------------------------------X-----------T---------------------------------o--------------------------------------T--------------------------------------of---
--------------------------------------------------------------X-----------------------|-------o----------------o-----------------------------------------------|-------------------------------------?-f---
m-E---------------------------------------------------------------------E-------------|------E-------------------------------------------------E---------------|-----E---------------------------------X---
XXXXXXXXXXXXXXXXXXXXXXXXXXXXXXXXXXXXXXXXXXXXXXXXXXXXXXXXXXXXXXXXXXXXXXXXXXXXXXXXXXXXXXXXXXXXXXXXXXXXXXXXXXXXXXXXXXXXXXXXXXXXXXXXXXXXXXXXXXXXXXXXXXXXXXXXXXXXXXXXXXXXXXXXXXXXXXXXXXXXXXXXXXXXXXXXXXXXXXXXXXX
