--------------------------------------------------------------------------------------------------------------------------------------------------------------------------------------------------------------
-------------------------------------------------------------------------------------------------------------------------------------------------------------o------------------------------------------------
----------------o-----------------------------------------------------------------------------------------------------------------B------------------------------------------------------------------o--------
--------o-------------------------------------------------------------------o-----------------------------------o---XX----------------------------------------------------------------------------------------
------------------------------------------------------------------------------------------------------------o-------------------------------------------------------------------------------------------------
------------------------------------------------------------------------------------------------------------------o-------------------------------------------------------------------------------------------
----------------------------------------------------------o-------------------------------?-------------------------------------------------------------------------------------------------------------------
----------------------------------------------o--------------------------------------------------------------------------------------------------------------------------------------------------------v------
--------------------------------------------------X--------------------------------XXX--------XXXXXXX----XXXX----XXXXXX-------------------------------------------o-----------?------------------------f------
-------------------------------------XXXX--------------XXXXX---------------------------------------TXXXXX------------XXX----------------------------------????-----------------------------------------f------
----------------------------------X-------------------------------XXXXX-------------BBBXBBBB-------|--------------------BBXB-----------XXXXX-----------------------------------------------o-----------f------
--------------------XXX----------------------XXXXXX---------XXXXXX---------------------------------|---------------------------------T-------------------------------BBBBBXB---------------------------f------
---------------------------------------------------------------------------------------------------|-------------------------XXXX----|-----------------------------------------------------------------f------
-----------------------------------------------------------------XXX--X--XXXXXX--------------------|-----XXXXX-----------------------|-------------------------------------------------o---------------f------
m-EE------------------------------------------------o---------------------E-----------E------------|---------------------------------|-----------------------------------------------------------------X------
XXXXXXXXXXXXXXXXXXXXXXXXXXXXXXXXXXXXXXXXXXXXXXXXXXXXXXXXXXXXXXXXXXXXXXXXXXXXXXXXXXXXXXXXXXXXXXXXXXXXXXXXXXXXXXXXXXXXXXXXXXXXXXXXXXXXXXXXXXXXXXXXXXXXXXXXXXXXXXXXXXXXXXXXXXXXXXXXXXXXXXXXXXXXXXXXXXXXXXXXXXXXXX
