-----------------------------------------------------------------------------------------------------------------------------------------------------------------------------------------------------------
-------------o----------X-----------?-----------------------------------------------o-----o----------------------------------------------------------------------------------------------------------------
---o-----------------------------------o----------------------------------------------------------------------------------o--------------------------------------------------o------------------X----------
------------------o--------------o-----------------------------------------------o------------------------------------------------------------------------------X--------o---------------------------------
-----------------------------------------------------------------------------------------oX-----------------------------------------------oo---------------------------------------------------------o-----
---------------------------------B------------------------------------------o--------------------------------?----o----------------------------------------------------------------------------------------
--------------------------B-B----------o----------o---------------------------------------------------------------------------------------------o-------------------------------X--------------------------
--------?-----------------------------------------------XXXX---------------------------------------o-B-------------------------XXX-----------------------------------B---------?--------------o--------v---
--------------------------------o---------------------X----------------------------------------XX?XXXXX----------------------------------------------------------------o-------------------------------f---
--------------------------X----------------------------o--------------------------------------o---------------------------XXXX-----------------------------------------------------------------o-------f---
------------------------------------------------------------------------------------------------------------------------------------------------------------o------------------X-----------------------f---
----------------------------XXXXXX-----X???------XXXX---B-----------???-?----XXXXX----------T--XXXXXX---------------------XXXXXXX--------T---Xo--------o-----BBBXB---o-------o-------------------------f---
-----------------o------------------------o-------------------------------------------------|--o------------------------o----------------|--------------?----------------------------------------------f---
-----------------------------------------------------------X--------------------------------|--------------------------------------------|-------------------------------------------------------------f---
m-E---------------------------------------------------------------E----------------------E--|--------------------------------------------|-E-----------------------------------------------------------X---
XXXXXXXXXXXXXXXXXXXXXXXXXXXXXXXXXXXXXXXXXXXXXXXXXXXXXXXXXXXXXXXXXXXXXXXXXXXXXXXXXXXXXXXXXXXXXXXXXXXXXXXXXXXXXXXXXXXXXXXXXXXXXXXXXXXXXXXXXXXXXXXXXXXXXXXXXXXXXXXXXXXXXXXXXXXXXXXXXXXXXXXXXXXXXXXXXXXXXXXXXXX
