-----------------------------------------------------------------------------------------------------------------------------------------------------------------------------------------------------------
-----------------------------------------------------------------------------------------------------------------------------------------------------------------------------------------------------------
---------------------------------------------------------------------------------------------------------------------------------o-------------------------------------------------------------------------
--------------------------------------------o--------------------------------------------------------------------------------------------------------------------------------------------------------------
-----------------------------------------------B-------------------------------------------------------------------------------------------------o---------------------------------------------------------
-----------------------------------------------------------------------------------------------------------------------------------------------------------------------------------o------------X----------
-------------------------------------------------------------------------------------------------------------------------------------------------------------------------------------------o---------------
-----------------------------------------------------------------------------------------------------B-------------------------------------------------------------X-----------------------------------v---
-----------------------------------------XXXXXXX------------------------------------------------------------------------------------------o-???--------------------------------------------------------f---
------------------------------------XXXXXX-----------------------------------o-------------XXXXXXX--XXXXXXXX--------------XXXX----------------------------XXXXX-o--------------------------------------f---
-----------------------------------------------------------------------------BBBBBBBB------------------------------------------------------------------XXXXXX---------------B-----o--------------------f---
--------------------------------------------------------T--------------------------XXXXXX--------------------------------------------BBBBB-------T-----------------------------------------------------f---
------------------------------------T--------XXXX-------|----------------------------------------------------------------------------------------|---------------------------------------------------?-f---
---------------X-------------XXXXXXX|--------o----------|-----------???????BBBBBBBB--------------------------------------------------------------|----------------o------------------------------------f---
m-E---------------------------------|-------------------|------------------------E---------------------------------------------------------------|-----------------------------------E-----------------X---
XXXXXXXXXXXXXXXXXXXXXXXXXXXXXXXXXXXXXXXXXXXXXXXXXXXXXXXXXXXXXXXXXXXXXXXXXXXXXXXXXXXXXXXXXXXXXXXXXXXXXXXXXXXXXXXXXXXXXXXXXXXXXXXXXXXXXXXXXXXXXXXXXXXXXXXXXXXXXXXXXXXXXXXXXXXXXXXXXXXXXXXXXXXXXXXXXXXXXXXXXXX

