-----------------------------------------------------------------------------------------------------------------------------------------------------------------------------------------------------------
-----------------------------------------------------------------------o----------------------------------------------------------X-----oo------------------------------------Xo---------------------o-----
-----?-----------------------o----------------------------------------------------------------------------------------------------------o------------------------------------------------------------------
-----------------oo-------------------------------------X--------------------------------------------------X-------------------------------------------------------o---------------------------------------
---------------------------------------------------------------------o---------------o--------BB-XBBo---o------X--------------------------------o----------------------------------o-----------------------
-------------?---------X--X-----------------------o----------------------X----------------------------------------------X----------------------X---------------------------------X-------------------------
----------o-------X-----------------------?--------------------B------------------------------o------------------------------------------------------------------------------------------------------------
------------X----------------------o----------------o------X-o------------------------------------------------------------------B------------------oX----------------------------------------------oo--v---
------------------------------------------------X------o---------------XBXB---------o-------B?B---------------------o-o---------?------X------------------------o-----X---------------------------o----f---
---X--------------X--oX-------------o-------------------oo-----------------------------------------------------------------o------------------------------------o------------X--X----------B-----------f---
-----------------------------------------o-----------------------------------T----------o----T-----o-------o-o-----------------------------------------T------------------------------------o----------f---
-----------------------XBX--------B------------BBBBB-?????-----------????----|-----BBB----BBB|----BBB-o----------T-----T----------To---T-------o-------|-------o-----------------------o-o------------of---
-----------------------------------------------------------------------------|---------------|-T-------------T---|--T-T|----------|-T--|----T------T--T|------T--B--o----------------------?-----------f---
-------------------------------------------------?-------o-------------------|---------------|-|-------------|---|--|-||----------|-|--|----|------|--||------|----------o-----------------------------f---
m---------------------------------------------------------------E-----------E|---------------|-|-------------|---|--|-||----------|-|--|----|------|--||------|---------------------E-E----------------X---
XXXXXXXXXXXXXXXXXXXXXXXXXXXXXXXXXXXXXXXXXXXXXXXXXXXXXXXXXXXXXXXXXXXXXXXXXXXXXXXXXXXXXXXXXXXXXXXXXXXXXXXXXXXXXXXXXXXXXXXXXXXXXXXXXXXXXXXXXXXXXXXXXXXXXXXXXXXXXXXXXXXXXXXXXXXXXXXXXXXXXXXXXXXXXXXXXXXXXXXXXXX
