-----------------------------------------------------------------------------------------------------------------------------------------------------------------------------------------------------------
--------------------o---------------------------------------------------------------------------------------------o------------------------o--------------------------o------------------------------------
-----------------o-------------o---------------------------------X---------o------------------------X-------------------------------------------------------o----------------------------------------------
-------------------------------o---o-------------------------------------------------o-----------------------------------o-----------------------------------------X------------------------X--------------
---------------o-----o------------X-------------------------------------------------------X------------------------------------------o--------o----------------------------------X-------------------------
------??-------o-------o------------------------------------?--o---------------X-------------------------------------------X------o-----------X-------X----X---?-----X--------------X----------------------
------------o-------------------------------X----X-----------------X---------------------o------X--------------o------------------------------o--------X-----------B--------------------------------o------
--------------------------------------------------------------------X---BBB?BX-----------------------o---o-------------------------X-------------------------------------------------------------------v---
---o----------------o------------X----------X------o------------------------------------------X------------B------------------------------------------T---------------------------------------o--------f---
----------o---------------------------o----------------------------------------------o-o----------------------------------------------------------o---|------X---------------------XX------------------f---
------------------------------------------------------------------------o----------------X---------------------------------------------o--------------|------------------------------------------------f---
--------------------------XXXXX-------------?????---???o----------------BBBBBBB---B--BBBBo?BBB------------------BBB---?BB-----------BBB-----------?B??|??----------------------------oo----------------f---
----------o------------------------------------------------------------------------------------o----T---------BB----------T--------o------------------|-----------------------------B------------------f---
---------------------------------------------X---------------------------------------?-o-----------B|---------------------|--------------------o-o-o--|------------------------------------------------f---
m-E-----------------------------------------------E----------------------o--------------------------|---------------E-----|-------E-------------------|-----------------E------------------------------X---
XXXXXXXXXXXXXXXXXXXXXXXXXXXXXXXXXXXXXXXXXXXXXXXXXXXXXXXXXXXXXXXXXXXXXXXXXXXXXXXXXXXXXXXXXXXXXXXXXXXXXXXXXXXXXXXXXXXXXXXXXXXXXXXXXXXXXXXXXXXXXXXXXXXXXXXXXXXXXXXXXXXXXXXXXXXXXXXXXXXXXXXXXXXXXXXXXXXXXXXXXXX
