-----------------------------------------------------------------------------------------------------------------------------------------------------------------------------------------------------------
-----------------------------------------------------------------o-------------------------------------------------------------------X---------------o-----------------------------------------------------
-----------------------------------------------------------------------------------------------------------------------------------------------------------------------------------------------------------
-----------------------------------o-----------------------------------------------------------------------------------------------------------------------------------------------------------------------
--------------------------------------------------------------------------------------------------------------------B---------------------------------X----------------------------------------------------
---------o--------------------------------------------------X--------X----------------------------------------------------------------------------------------------------------------------------X--------
---------------------------------------------------------------------------------------------------------------------------------------------------o-------------------------------------------------------
--------------------X---------------------------------------------------------------------------------------------------------------------------------------------X------------------------------------v---
-------------------------------------------????---------???????-------XXXX---------B-------XXXXXXX-BBBBB--------XBXBXXXXXXX--------------------X-------------------------------------------------------f---
--------------------------------------XXX-----------------------XXX-XX-----------------------------------------------T-o---------------------------------------T---------------------------------------f---
---------------------------------------------------------XBBX------------X---------------------------o---------------|---------------T----XXXXX----------------|---------------------------------------f---
---------------------------------------------------------------------------------------------XXBXXXX--???------------|---------------|----BBBBB----------------|---------------------------------------f---
------------------------------o------------------------------------------TXXX-XXXXo---XXXX---------------------------|---------------|----oo-------------------|---------------------------------------f---
------------------------------------------XXX-----------B----------------|-------------------------------------------|---------------|-------------XXXXXX--BBBB|---------------------------------------f---
m------------------------------E----------------E--------------E---------|-------------------------------------------|---------------|-------E-----------------|------------E--------------------E-----X---
XXXXXXXXXXXXXXXXXXXXXXXXXXXXXXXXXXXXXXXXXXXXXXXXXXXXXXXXXXXXXXXXXXXXXXXXXXXXXXXXXXXXXXXXXXXXXXXXXXXXXXXXXXXXXXXXXXXXXXXXXXXXXXXXXXXXXXXXXXXXXXXXXXXXXXXXXXXXXXXXXXXXXXXXXXXXXXXXXXXXXXXXXXXXXXXXXXXXXXXXXXX
