-----------------------------------------------------------------------------------------------------------------------------------------------------------------------------------------------------------
----------------------------------------------------------o--------------o----------------------------------------------------------o-----------------------------------o----------------------------------
------------------------------------------------------------------------------------------------------BBBBB------o-----------------------------------------------------------------------------------------
-----------------------------BBBBB--------------------------o------------------o-------------BBXB--------------------------------o------------------------------------------------o------------------------
----------o----------------------------o--------------------------------------------------------oBB-BXBBB-------------------------o-----------------------------------X------------------------------------
--------------X-----B---------------------B--o------------BBBB?X----------?--------X------------E------------ooo--BBBBB--------------BBo-----------B--------------------------B---------X-------------o----
------------------------------E------------------------------------------------------------X-?????------------------------------o---------------------------------XX?XX-----------------o------------------
---------------------------?????--------BBB-----------------------X---BBBB----------------------------o---------------o-XXBXX--X---------------------oBBBX------------------X--------------------------v---
------------------------o-----E-B-----------o-----------BBXB------o---------XXXX------o-----------o----------XBBBBB-XX-T-----BB---o--------------------------------------X?XXXXXX--------o-------------f---
-----------------------BBo----BBX--------------------o-o------------------T-------?--??X?-BB--------XXX----o-----------|-----------B?BXBB?X---oX--B--------B--BBBBBXXB---------------------------------f---
-------------E-E----------E---E-----------------------E------T--------E---|------------------------------o---o---------|----------------o--------------------X-----------------------------------------f---
-----------BBBBB--------XXXXXXXX-XBB-XBBBBXB---B?XB---BBBBB--|--B?BXXXXXX-|XXX-BBBBXBX????TX---XTXXXB----BBBBX--BXBB--B|BBB--B---BXX----TBBBBB-T--X--XBBBBXX--BBTB----BBBBB--------------------------o-f---
--------------o----------o----------------------------T------|--------o--T|-----------X---|-----|------------o---------|----------------|------|---------------o|-----------------X--------------------f---
-------------------------------------------------B----|------|-----------||---------------|-----|----------------------|----------------|------|----------------|------------------------------------o-f---
m-E------E---E-E-E-----E-------E-E--E--EE--E----E-EE-E|--E---|---E-------||-E----E--------|--E--|E----------E---------E|------EE--------|-E----|----------E-E---|----------------E-----E---------------X---
XXXXXXXXXXXXXXXXXXXXXXXXXXXXXXXXXXXXXXXXXXXXXXXXXXXXXXXXXXXXXXXXXXXXXXXXXXXXXXXXXXXXXXXXXXXXXXXXXXXXXXXXXXXXXXXXXXXXXXXXXXXXXXXXXXXXXXXXXXXXXXXXXXXXXXXXXXXXXXXXXXXXXXXXXXXXXXXXXXXXXXXXXXXXXXXXXXXXXXXXXXX
