--------------------------------------------------------------------------------------------------------------------------------------------------------------------------------------------------------------
-------------------o----------------------------------------------------o---------------------------------------------o-------------------------------------------X----X--------------------------------------
------------------------------------o-------------------------------------------------------------------------------------------------------------------o-----------------------------------------------------
-----------------------------------------------o-----------------------------------------------o-------------------o------------------------------------------------------------------------------------------
----------------------------------------X-------------------o--------o-----------o--------X--------------------------E--------------------------------------------------------------------------------o-------
-B--------------------------------------o------------------------------------------------------------------B?B-BBX?BBBB---------------------o-----------------------------------------------------------------
--o-----------o----------------------------------------------------------------------------------------------------X--------------------------------------------------------------o---------------------------
-----------------------------------------------------B-------------------------------------------------------o------------------BBBXBB-------X------------------------------------------------------o--v------
--------------------B-----------------------------------------------------------------------------o----------------------------------------------------------------------------------------------------f------
--------------------------------------------------------------------X----------------------------------BBB-XBBBX--------------------------------------XXXXX--------------------------------------------f------
-----------------------------------T---o---------------------------T-----------------------------------------------------------------------------------------------------------------------------------f------
--------------------------BBB---BBB|BBB---BBB--------o----B-XXXXXXX|--------XXXXX----BBBBBBBB------X-?XX????-----BBB--BBB-----?BBBBXBX-----------------------------------------------------------------f------
-----------------------------------|-----o-------------T-----------|------T------X--------T----------------------X----------------o--------------------------------------------------------------------f------
--------o--------o-----------------|-------------------|-------o---|------|---------------|------------------------------------------------------------------------------------------------------------f------
mEE-E-----E-----------------------E|--------E----------|-----------|------|---------------|-------------------------------------E----------------------------------------------------------------------X------
XXXXXXXXXXXXXXXXXXXXXXXXXXXXXXXXXXXXXXXXXXXXXXXXXXXXXXXXXXXXXXXXXXXXXXXXXXXXXXXXXXXXXXXXXXXXXXXXXXXXXXXXXXXXXXXXXXXXXXXXXXXXXXXXXXXXXXXXXXXXXXXXXXXXXXXXXXXXXXXXXXXXXXXXXXXXXXXXXXXXXXXXXXXXXXXXXXXXXXXXXXXXXX
