-----------------------------------------------------------------------------------------------------------------------------------------------------------------------------------------------------------
-------------------------------------X--------------------------------------o-----------------o--------------------------------------------------------------o---------------------------------------------
------------------------------------o---------------------------------------------------------------B----------------o------------------------------------o--------o---------------------------------------
----------------------------o------------o-----------------o----o------------------------------------------------------------------------------------------------------------------------------------------
---------------------o------------X----------------------------X--------------------------------------------XXX----------------------------X---------------------------------------------------------------
----------B---------X-------------------------X------------------------------------X---------------------------------XXXXXXX------------------?------------------------------------------------------------
----------------X------------------X---------------------------o--------------------------------------------------------------------------------------------------------------X----------------------------
-----------------------------------?---------------------B------------o---------------oo---------------o--XXXX----XXXXXX--------------------o--XXX-o-----X--------------X-------------------X----------v---
-----------------o------------X--------------------------XX----------------------------------------------------------------------------o------------------------------------------------------X------X-f---
---------------------------------o--X-------B--------------------X-------------------X-------------------------------------------o--------------?---------------------------X------------------B-------f---
------------------X----------------------o------------------------------------------------------------------o--------------------------------------------------------o---------------------------------f---
-------------XXXXXX-X----o-X----------XXXXXX--??????---XXX------------------------o---X?X-?XX--XXXXXX--XXXX-------XXXXXXX--o-------------------XXX----BBB-------XXXXXXXX-------------------B-----------f---
------------------------------T--------------------o-----------------------------------------------------------------o---------------T------------------o---------o-o----------------------------------f---
-----X---o--------------------|------------------------o----------------------------------o------------------------------------------|-----------------------------------------------------------------f---
m----------------------E------|-------------------E-------------------o----------------------E---------------------------------------|-----------------------------------------------------------------X---
XXXXXXXXXXXXXXXXXXXXXXXXXXXXXXXXXXXXXXXXXXXXXXXXXXXXXXXXXXXXXXXXXXXXXXXXXXXXXXXXXXXXXXXXXXXXXXXXXXXXXXXXXXXXXXXXXXXXXXXXXXXXXXXXXXXXXXXXXXXXXXXXXXXXXXXXXXXXXXXXXXXXXXXXXXXXXXXXXXXXXXXXXXXXXXXXXXXXXXXXXXX
