-----------------------------------------------------------------------------------------------------------------------------------------------------------------------------------------------------------
-----------------o-----------------------------------------------------------------o-----------------------------o--------------------o--------------o-------------------------o---------------------------
---------------------------------?----------------------o--------------------------o----------------------------------------------------------B------------------------------------------------------------
---------------------o--------------------o-----------------------------------------------------------------------o----------------------------------------------------------------------------------------
-----o-?----------------------------------------------------------------------------------------------------?----------------------------------------------------------------------------------------------
-----o--------------------------X-----------------------------------------------------------------X--------------------------------------X-----------------------------------------------------------------
--------------------------o-----------------------------o--------------------------------------------------------------------------------------------------------------------------------------------------
--------------------------------------------------------E-------------------------------------------------------X--------------------------------------------------------------------------------------v---
-------------?---------------X--------?---------o---BBBBBB-----------------X------X-----------------------------------------------------X--------------B----BBB-------------o--------------------------f---
--------------------o-----------------------------------------------------------------------------XXXX-------------------------------------------XXXXX-------------------------------------------------f---
----------------------------------------------------------o------------------------------------------------------------XXXX---------XXXXXX-BXB------------XXX------------------------------------------f---
---------------------------------------------------------------------o---T--o-X?XXXXX------------------------------------------------------------------------------X-----------------------------------f---
--------------o-----------------XXX----------o----X----------------------|-------------------------------------B-------------o----X-----o----------------------------------------------o-----------o---f---
---------------------------o---XXX------------------------------BBBBB----|----------------------------------XXBXXX------------XXXXXX--------------------------------------------B----------------------f---
m----------------E--------------E------E---------------------------------|-----------------------------------------------------------------------------------------------------------------------------X---
XXXXXXXXXXXXXXXXXXXXXXXXXXXXXXXXXXXXXXXXXXXXXXXXXXXXXXXXXXXXXXXXXXXXXXXXXXXXXXXXXXXXXXXXXXXXXXXXXXXXXXXXXXXXXXXXXXXXXXXXXXXXXXXXXXXXXXXXXXXXXXXXXXXXXXXXXXXXXXXXXXXXXXXXXXXXXXXXXXXXXXXXXXXXXXXXXXXXXXXXXXX
