-----------------------------------------------------------------------------------------------------------------------------------------------------------------------------------------------------------
-------------------o--------------o---------------------------B-------------------------------------------------o------------------------------------------------------------------------------------------
--------------------------------------------------------------------------------------------------------------------------------?----------------------------------------------------X---------------o-----
----------------------------------------------------------?------------------------------------------------------------------------------------------------------------------------------------------------
----------------------------------------X-------------------o------------------X----------------o--------------------E---------------------------------------------------X---------------------------------
--------------------------------------------o--------------------------------------------------------------BBB-BBXBBBBB--------------o------o------o-------------------------------------------------------
-------------------------------------------------------------------------------------------------------------o-----X-----------------------------------------------X---------------------------------------
--------------------------------------------------------------------------------------------o-----------------------------------BBBBBB-----------------------------------------------------------------v---
---------------------------------------------------------------------------------------------------------------------------------------------------------------------------------------o---------------f---
--------------------------------X-------------------------------------------------------X--------------BBB-BBBBB--------------------------------------XXXXX-------o-----?BBB--------o------------------f---
---------o-----------------o-------T-------------------------------T----------------------X----------------------------------------------o-------------------------------------------------------------f---
--------------------------BBB---BBB|BBB---BBB---------------XXXXXXX|--------XXXXX----BBBBBBBB--------??????X-----BBB--XBB-----B-BBBXBB--------o--o---------------BBB--B?BBBB--------------------------of---
--------X--------------------------|-----o-------------T-----------|------T---------------T--------------------------------------------------------------------------------------------o---------------f---
-----------------o-----------------|-----------?-------|-----------|------|---------------|------------------------------------------------------------------------------------------------------------f---
m-E-----E-------------------------E|--------E----------|-----------|------|---------------|-------------------------------------E------------------------------------E---------------------------------X---
XXXXXXXXXXXXXXXXXXXXXXXXXXXXXXXXXXXXXXXXXXXXXXXXXXXXXXXXXXXXXXXXXXXXXXXXXXXXXXXXXXXXXXXXXXXXXXXXXXXXXXXXXXXXXXXXXXXXXXXXXXXXXXXXXXXXXXXXXXXXXXXXXXXXXXXXXXXXXXXXXXXXXXXXXXXXXXXXXXXXXXXXXXXXXXXXXXXXXXXXXXX
