-----------------------------------------------------------------------------------------------------------------------------------------------------------------------------------------------------------
-------------------o---------------------------------?------------------------------------------------------------------o-----------------------------------------------X-------------------B--------------
---------B------------------------------------------------------------------------------------------------------------------------------------o----------------------------------?-------------------------
---------------------------------------------------------------------o-------------------------------------------------------------------------------------------------------------------------------------
--------------------------------------------X---X--------------X--------------------------------o----------------------------o-----B-----------------------------------------------------------------------
-----o------------X--------------o---X------------------X-----------------BBBX----------------X----------------o--------------------o--------o------?----X???-------------X--o-----------------------------
-----------------------X----------------------------o-----------------o------------------------------------------------------------------------------------------------X--------------o--------------------
---------------------------------------------------------------------------XXXX---BXBBBB--------------------X---------------B------------o-----------BXBBBBB------------------------------X------------v---
-----------------------?-----------------------------------------T---------------T-----o---------------------------BBBBBB----------------------------------------------------------------o-------------f---
-----------------------------XT----T-----------B-?---------------|--BBBBBBB-X----|------------X-----------------------------o--B--------------------------------------------------o---------o----------f---
--------o-------------o-------|----|-----------------------T-o---|--B------------|------------------------o-------------------------To-------T-----------------------X-----oo-------X------------------f---
------------BBB-BB----------BB|XTBB|---------??B-------BX--|---??|--BBXBBBBBo--BB|BBB-BB--------BBX-T-----------XB-BB?BB---B?-------|-----oT-|-????XX?X---XBBBBB----X----------------------------------f---
------------------------------|-|--|-----------------------|-T---|------------o--|----o-------------|----------T---------------o----|------|-|-------------------------------X-------------------------f---
------------------------------|-|--|-----------------------|-|---|---------------|------o-----------|----------|--------o-----------|------|-|--------o------------------------------------------X-----f---
m---E-----E-------------------|-|--|-----------------------|-|---|---------------|------------------|----------|--------------------|------|-|-----------------------------------------------E---------X---
XXXXXXXXXXXXXXXXXXXXXXXXXXXXXXXXXXXXXXXXXXXXXXXXXXXXXXXXXXXXXXXXXXXXXXXXXXXXXXXXXXXXXXXXXXXXXXXXXXXXXXXXXXXXXXXXXXXXXXXXXXXXXXXXXXXXXXXXXXXXXXXXXXXXXXXXXXXXXXXXXXXXXXXXXXXXXXXXXXXXXXXXXXXXXXXXXXXXXXXXXXX
