-----------------------------------------------------------------------------------------------------------------------------------------------------------------------------------------------------------
-----------------------B--------------------------------------B---------------o-----------------------------------X--------------------------------o---------------------o-----------o-----X---------------
-------------------------------------oo--------------o-------------------------------------------------------o-------------------o------------------------------o------------------------------------------
-----------------------------------------------------------------------------------------------------X----------------------------------------------------------------------o------------------------------
----------------------------------------------------------------------------------------o---------------o--------------------------------------------------------------------------------------------o-----
--------X---------------------------------X--------?--------o----------?--------------------------o-----------o----X----------------------------------------------------------X---------o------------------
--------o----B--------------------------------------------X---------------------------o-------B-------------------------o--------------------------o-------------------------------?-----------------------
-------------o-----B----------------------------------------o--X---------------------------------------oo----?----------------------B-----------------------------------------------------X-----o------v---
-----------------------------------------------------------X---------------o-----X------------?----------------------------------------------------------------------------X-------------o-------------f---
------------------X------------------?------------X----------T------------------------------------------------------o---X---------------------------------------?--------o-----------------------------f---
-------------------------------------------------------------|-----o--------------------?---------------------------------oB--------------------T----------o-B--------X--------------X----o------------f---
---o-----------------X-----------o----o----T-----------------|--------------------------------------------------------------------o-----T----T-o|--------------B--------X----------------B----o--------f---
-------------------------------------------|-o----o----XoT---|---------------------------------------------------T----------------------|----|--|--------------T---------------X-----------------------f---
-----------------X-------------------------|-----X-------|---|----------------------X-----o----------------------|----------------------|-o--|--|----------o---|--X-----------B------------------------f---
m----------------------------------------E-|-------------|---|-----------E---------------------------------------|----------------------|----|--|-E-------o----|---------------------------E-----------X---
XXXXXXXXXXXXXXXXXXXXXXXXXXXXXXXXXXXXXXXXXXXXXXXXXXXXXXXXXXXXXXXXXXXXXXXXXXXXXXXXXXXXXXXXXXXXXXXXXXXXXXXXXXXXXXXXXXXXXXXXXXXXXXXXXXXXXXXXXXXXXXXXXXXXXXXXXXXXXXXXXXXXXXXXXXXXXXXXXXXXXXXXXXXXXXXXXXXXXXXXXXX
