------X-?--X---|---o-|E|-----oE---------E---------M-|----------E-------o-----------------M--o-T----T-?--------E------M-----B---X-----EX-B---B|------?---------E---ME-----T--M----------o----|X----|-----
-E---B-T?M---------M--------T-|-------E-T------------X---------------o-M----|------XE--|---------EM-E-----|-----------T------------------BE---B----B------o--E----------E----T---ToX-E----T----T--------
--------------------|--B-----E-T--B---B-----M------------X-T--M|----|--------?---T--------M----B--------o--o--B|-----------T-M---XE-To-o--E--EB-E---B|-X-----T--------------T----|-T-?--XBT--M----------
---X---------?------E--------BT-----------||---o?-------B-B--B----M---?----------------------X----MT----E---M--|--------M----XE----------------B------E--X--------M-------?-----------o---M-----B?E-----
-----------B--------TT--?----TTo|------M--|---M----EBoXE----?--T-----B?------T----------X---T--o-oM------M-------------?M----------o----------E-MB-----E----B|--|-M?----------?------------|----TB---T--
-?-----T-T-o------------------------X--o----?o--B-----B------?---T------|----Mo---T--?-------------M|-----------M--o-------------??M?X----?----T-----M--?-------?-T--------T--B-X-X----?--E------X--o|--
-----M-E-oB------------?-X---B-----BB--?XM--o----------|M-----E?--BB--E||-o---X-o-E--|-------E-B--X--T-----E---|--------X--B----TMX-|-----|------T-o-?------EoB----?-|---------X-BB--ME-?----E--X?-|----
-|--o------E------oT-------B--MX------------------------?-||---E|X--------EE-------?-----T----B|--BXM---------|----X-M--T?-Bo--?-------o--o-XTE-E---?---M----------X--------BM-T-----MB-T?-------------v
-X--T--------X------------B--oT-----T--T?---X--oBT-------o|---|----M------------------------------------M-----------BE---T-----To-?-------E---------B--TB----?---o-----E------M-----------oT|----------f
-------E-B--E------------o-B-X----o--E--------------B-B--E--X-M--------T--------E--X----------------------------|E--?E--|--------------------------------?-|-B-B------------E---------------------XE---f
----?B---T--ME--?--E---------------------X--MT-----T-----------T-----XET------X-|--|------------|-|----------------Mo--?MM|M--X-M-?-------------B-?------o--------o---------------o---|B-----E-ME---X--f
-?--?--T--M-?------?o-----|------EB-------T----T-ET-T--oE|--B----------X---?-oX----B--?---X---T--------M----?M-----o-M---E-E------|-----------M---MX-----o----oE--X----o---|-----E-B----B----T--|---|--f
-XB-----------|M---T--------------M------?|?---X-X-M--X-MX------E--M-|T-T-E----M---------------|------------E-------X--E--T--?EX------------------XB------------?-X----?-----T--T----E-X--X----X-------f
-?--T---|----X-------------|-M-|M--o--?---EX-?X--------M--o------------oE---E-----o--B--X---------MT-?T-----B-------B----T---o-|-----BB---T---X--------T-E-T----X?--|---E-E------?-----B|-T--X?---X----f
m------------------------------------------------------------------------------------------------------------------------------------------------------------------------------------------------------X
XXXXXXXXXXXXXXXXXXXXXXXXXXXXXXXXXXXXXXXXXXXXXXXXXXXXXXXXXXXXXXXXXXXXXXXXXXXXXXXXXXXXXXXXXXXXXXXXXXXXXXXXXXXXXXXXXXXXXXXXXXXXXXXXXXXXXXXXXXXXXXXXXXXXXXXXXXXXXXXXXXXXXXXXXXXXXXXXXXXXXXXXXXXXXXXXXXXXXXXX
