-----------------------------------------------------------------------------------------------------------------------------------------------------------------------------------------------------------
-------------------------------------------------------------------------------o--------------------o------------------------------------------------------------------------------------------------------
-----------------------------------------------------------------------------------------------------------------------------------------------------------------------------------------------------o-----
------------------------------------------------------------------------------------o-----------------------o----------------------------------------------------------------------------------------------
---------------------------------------------------------------o-----------------------------------------------------------------o-----------o-------------------------------------------------------------
-------------------------------------------------------X------------------------------------------------------------o--------------------------------------------------------------------------------------
---------------------------------------------------------------B------?---------------------------------------------X--------------------------------------------------------------------------------------
-----------------------------------------------------------------------------------------------------------------------------------o-------------------------------------------------------------------v---
--------------------------------------------------------???????-----------------------BBBB-----------XXXXXXXX----XXXXXX-------------------BBBB---XX-----------T----o----------------------------o------f---
---------------------------------------------X------------------XXX---------o---------XXX---------------------------------------------------------------o-----|----------------------------------------f---
---------------------------------------------------o-----XXXX-------------XXXXXX--T--------------------------------------------------T------------------------|----------------------------------------f---
-------------------------------T---------------------------------------XXXXXXXX---|--------------------------XXXXXXX-----------------|-------XXXXX---XXXXXX---|----------------------------------------f---
---------o---------------------|-------------------------------------------X------|--------------------XXXXXX---------------------XX-|-o-----------------X-X-X|X---------------------------------------f---
-------------------------------|--------------------------------------------------|---------------------------------------------XXXX-|------------------------|----------------------------------------f---
m------------------------------|----E-----------E--------------E------------------|------o------------------------------E------------|------------------------|---------E------------------------------X---
XXXXXXXXXXXXXXXXXXXXXXXXXXXXXXXXXXXXXXXXXXXXXXXXXXXXXXXXXXXXXXXXXXXXXXXXXXXXXXXXXXXXXXXXXXXXXXXXXXXXXXXXXXXXXXXXXXXXXXXXXXXXXXXXXXXXXXXXXXXXXXXXXXXXXXXXXXXXXXXXXXXXXXXXXXXXXXXXXXXXXXXXXXXXXXXXXXXXXXXXXXX
