--------------------------------------------------------------------------------------------------------------------------------------------------------------------------------------------------------------
---------------------------------------------------------------------------------------------------------------------------------------------------------------------------------------------------o----------
---------------------------------------------------------------------------------------------------------------------------------------------------------------------o----------------------------------------
------------o-----------------------------------------------------------------o-------------------------------------------------------------------------------------------------------------------------------
-------------------------------------o?-----------------------------------------------------------------------------------------------------------------------------------------------------------------------
----------o---------------------------------------------------------------------------------------------------------------------------------------------------------------------------------------------------
-----------------------------------------------------o-------------------------------------o-------------------------------------------------X----------------------------------------------------------------
------------------------------------------------------------------o---------------------------------------------------------------------------------------------oo-------------------o-----------------v------
---------------------------------T--------------------------XXXXBXXX--XXXXXXXXXX---XXX----------------------------------------XXXX----------------------XXXXXXX----------------------------------------f------
---------?-----------------------|----------------------------------------------------?--------------------o-------------------------------------------------XXXXX-------------o-----------------------f------
---------------------------------|--------------------X--------------------------------------------------XXXXXXXXXXX----------------------XXX----------------------------------------------------------f------
----------------------------o----|---------------------------------------------------Bo-----------------------------------XXXX------------------------------------X------------------------------------f------
--------B--------o-------------BB|------------------------------------------------------B----------------------------------------------------BXXXXX----------------------------------------------------f------
--------------o------------------|------------------------------------o-----o--------------?-----------------------------------------------------------------------------X-----------------------------f------
m---------E----------------------|----------------------------------------------------------------------------------------E-----------------------------E----------------------------------------------X------
XXXXXXXXXXXXXXXXXXXXXXXXXXXXXXXXXXXXXXXXXXXXXXXXXXXXXXXXXXXXXXXXXXXXXXXXXXXXXXXXXXXXXXXXXXXXXXXXXXXXXXXXXXXXXXXXXXXXXXXXXXXXXXXXXXXXXXXXXXXXXXXXXXXXXXXXXXXXXXXXXXXXXXXXXXXXXXXXXXXXXXXXXXXXXXXXXXXXXXXXXXXXXX
