--------------------------------------------------------------------------------------------------------------------------------------------------------------------------------------------------------------
-------------------------o----o-----------------------------------o------------------------o------o------------o--------------------------------------------------o------------------------------o------------
-----------------------------------------------------?------------------------------------------o-----BBBBX----------------------------------o----------------------------------------------------------------
--------------------------------------------o------------------------------------------------BBBB------------------------------------------------------------------------------o-------------o----------------
------------------------X----------------------------------------------------BBB----------------XBBBXXBBB------------------------------------BBB--------XXX--------o---X-----------------------B--------------
--------------X-----B---------BBB------------o-XXXX------------BBB------------------------------E-----------------BBBXB-----o------BBBB---------------------------?-------------o-X---------------------------
---------------------------------------------------------?---------------------------------????XX?-------------------------XB-------o-------B-BB-----o--------------------------------------X-----------------
---o--------------------------XBBBBBB-------XXXX---------------------------------------BBB------------o-----------------XXXX------------------E----BBBX?XB-----------------------o----------o----------v------
-------------------X---------------------------------------------B-----------??????---------o----------------BBXBBBBX--T-------X---X-------BBBBB------------------BBBB---XXXXXXXX--------------o-------f------
-----------------------------------------------TBBB---------B-B---------------------o--BB-XB--------X?X----------------|-----B?BBBBB----------T--------------------------------------------------------f------
-------------E-E------------------------------E|-------------------------------------------------------------o----o----|-X-----o-----------E--|T--------------o---o------------------------------------f------
-----------BBBBB-------------BBBBB-----XBBBBX-B|BBBBB----?B????XXXBB--BBBBBBB-------XXXXX?T?---XTXXXX----BB-XBB-BBBX--B|BBB-BBB--T-X--BB--BBBB||BX-?------BBBB-B?XB----BBBB--------B-------?-----------f------
-----------------------------------------------|--------------------------o----------T----|-----|----------------------|---------|------------||------------o------------------------------------------f------
---------------------o-------o-----------------|--------------------------o----------|----|-----|------o----------X----|------B--|------------||-------------------------------------------------------f------
m-E------E---E-E-E------E--------EE-----E----E-|----E-E---E--------EE---EE--E-----E--|E-E-|--E--|E----------E---------E|---------|E-----E--E-E||-------E--EE--EE-E-E-------------E-----E---------------X------
XXXXXXXXXXXXXXXXXXXXXXXXXXXXXXXXXXXXXXXXXXXXXXXXXXXXXXXXXXXXXXXXXXXXXXXXXXXXXXXXXXXXXXXXXXXXXXXXXXXXXXXXXXXXXXXXXXXXXXXXXXXXXXXXXXXXXXXXXXXXXXXXXXXXXXXXXXXXXXXXXXXXXXXXXXXXXXXXXXXXXXXXXXXXXXXXXXXXXXXXXXXXXX
