-----------------------------------------------------------------------------------------------------------------------------------------------------------------------------------------------------------
------------------------X-------------o----------------------------------------o------------------------o----------------------------------------------------------------------o----------B----------o-----
-------------------------------------------------------------------------------------------o-o---------------------------------------------------------------------------------------------------o---------
-----------------------------------------X-------------------------------------------------------o-------------------------o--------------------X----------------------------------------------------------
---------------------------------------------------------o--B----------o------------------------------------------------------------------------o----------------------o-----------------o-----------------
-------------?----------X--------------------------B-B----------------ooB------------------------------------------------BBB-BB----o---------------------------------------------X---------o--X------------
---------------X------------------------------------B----X----o--------------------------?----?---------------?---------------------------o---------------------o---B----------------------------o---------
------------------------------------------------X-------------------------X----------------------------------X---------XXXXXXX---------------------oXX---------------------------------------------o---v---
-----------------------------------------o-----------------------------------------------------o----------------------T-----------------------------------------------X---------------------------o----f---
---X---------------------------------------To--------------------o--------------------------------------T-------------|o-----------------------------------------o-----------X-------------------------f---
--------o------X-----------------X-------o-|----------------?--------o-----------------------------T----|-----T-------|--------------------------------T------------------------------------o----------f---
------------------?BXBB-----------B----XXBB|B-----------?X?BB-----------------XT--B---------XXXXX--|--BX|BBBB-|------BT--------------------------------|--o-X--------------------------o-o------------of---
-oo----------------------------------------|-----------------------------------|-TT---o----------o-|----|-----|-------|-----------X---T-----T------T--T|------T--B--o---------o------------------------f---
---------------o-----------------------?---|o-----------------------------o----|-||-----------X----|----|-----|-------|---------------|-----|------|--||------|-------------------o-----------o--------f---
m------------------E-----------------------|--------------------E--------------|-||----------------|----|-----|-------|---------------|-----|------|--||------|---------------------E-E----------------X---
XXXXXXXXXXXXXXXXXXXXXXXXXXXXXXXXXXXXXXXXXXXXXXXXXXXXXXXXXXXXXXXXXXXXXXXXXXXXXXXXXXXXXXXXXXXXXXXXXXXXXXXXXXXXXXXXXXXXXXXXXXXXXXXXXXXXXXXXXXXXXXXXXXXXXXXXXXXXXXXXXXXXXXXXXXXXXXXXXXXXXXXXXXXXXXXXXXXXXXXXXXX
