--------------------------------------------------------------------------------------------------------------------------------------------------------------------------------------------------------------
---------------------o----------------------------------------o-------------------------------------------------------------------X--------o-----------------------------------o--------X----------o----------
---------------------------------------------------------------------------------------------------------o----------------------------------------------------------------------------------------------------
-------------------------------------------------------------------------------------------------------------------------------------------------B--------------o-----------------------------X---------------
----------------X----------o---------------B-o----------------X------------------------------------------X----------oX----B-----------------------------------------------------------------------------------
----------------------o-------?------X--------------?????----------------X--------------------------------------------------------------------------------X---------------------------------------------------
-o------------------------------------o---o----------------------------B------o------------------------------------------------XXXXXXXX--o-----------------------------------------------B--------------------
-----------------------------oo--------------o-------------------XBX-------------------------------------o-------------?B-BB----------------------X--------o----B--------------------------------------v------
-----------?-----------------------o-------------------------------------------------?XXBXX-------------B---------------------------------------------------------------B------------------------------f------
--------------------------------------------------XXXX-o---------XX?XX--------------------------B--o-----------X-----------X------------------------------------------------X----------------oX--------f------
---------o------------------------------------------------------------------------------------T-------------------------------XXXXXX--o-----------------------o---o----------------------------------o-f------
------------XX----XXXX-----------XXX------------XXX-------T-XXXXXXXXXXXX--XXXXXXXXXXXXXX------|-----------T----------B-BBBBB-XX-------------------X?-------------------------------------o----X--------f------
----------------------------------------------------------|-----------------------------------|-----------|-----------------------------------------------------o--------------?-----------------------f------
----------------------------------------------------------|-----------------------------------|-------o---|----------------------o------------oo---------------------------o--o-------------o-X--------f------
m-E--------E---E------------------------------------------|-----------------------------------|-----------|-------------------------------------------------------------E------------------------------X------
XXXXXXXXXXXXXXXXXXXXXXXXXXXXXXXXXXXXXXXXXXXXXXXXXXXXXXXXXXXXXXXXXXXXXXXXXXXXXXXXXXXXXXXXXXXXXXXXXXXXXXXXXXXXXXXXXXXXXXXXXXXXXXXXXXXXXXXXXXXXXXXXXXXXXXXXXXXXXXXXXXXXXXXXXXXXXXXXXXXXXXXXXXXXXXXXXXXXXXXXXXXXXX
