-----------------------------------------------------------------------------------------------------------------------------------------------------------------------------------------------------------
-------------------------------------o----B-------------------------------X------o--------------X?---------------------o-----------------------------------------------------------------X-----------------
------------------------------o----------o-o--------------------------o------------------o-------------------------------------------------------------------------o------------X--------------------------
----------------------------------------o------------------------------------------------------------------------------------------------------------------------------------------------X-----------------
------------X------o------X----------X-----------------------------------------------------o-BXBBBBB-o--------------------------------------------------X--------o-----------------------------------------
-o--------------------------------o-X--------------------o--------------------------------------------------?------------------X-o-----------X---?---------------B---o-----o-------------------------X-----
---------------?---------------------------------------------?---------X--------------------------o----o-----------------------------------------------o--------------------?----------------?--o----------
---------------------------------------X------------X--------------------------------o-BXBBBBBX---------------------------E----------o----------------X---o?-------------o-----------------------------v---
---B-----------o-?--------B-----------------------------------------------BBBBBX-----------------o-o------------------??????---------------------------------T---------------------------X-------------f---
--------------------o----o----------T----------oo-----------------------------------o----------------------BBB--------------------------o--------------------|---------------X-------------------------f---
------------------------------------|-------------------o----------T---------------------------------T---------------------------------o-------------------o-|--------------------------------o--------f---
----X------------------------------B|B------------XXXX-------------|------BB--------XXXXXXX----------|--------------BBBBX----------------------T--------o---B|B-------------------------X--------------f---
------------------------------------|--T---o----------------T----o-|o---T-----------X------o------T--|---TT--------------------------X---------|---o---------|-----------------------------------------f---
----o-------------------------------|--|-----o--------------|------|----|X--------o-----------o---|--|---||------------------------------------|-------------|------------------------------X----------f---
m-----------------------------------|--|--------E-----------|------|----|------------E------------|-E|---||------------------------------------|-------------|--E--------------------------------------X---
XXXXXXXXXXXXXXXXXXXXXXXXXXXXXXXXXXXXXXXXXXXXXXXXXXXXXXXXXXXXXXXXXXXXXXXXXXXXXXXXXXXXXXXXXXXXXXXXXXXXXXXXXXXXXXXXXXXXXXXXXXXXXXXXXXXXXXXXXXXXXXXXXXXXXXXXXXXXXXXXXXXXXXXXXXXXXXXXXXXXXXXXXXXXXXXXXXXXXXXXXXX
