--------------------------------------------------------------------------------------------------------------------------------------------------------------------------------------------------------------
--o-------------------------------------------------------------------------------------------------------------------------------------------------------------------------o---------------------------------
-------------------------------------------------------------------------------------------o------------------------------------------------------------------------------------------------------------------
----------------------------------------------------------------------------------------------------------------------------------------------------------o---------------------------------------------------
---------------------------------------------------------------------------------------------------------B---X------------------------------------------------------------------------------------------------
----------------------------------------------------------------X--------?---------------------------------------------------?------------?----X--------------------------------------------------------------
----------------------------------------------------------------------------------?---------------------------------------------------------------------------------------------------------------------------
------------------------------------------------------o--------------------------------------------------------------------------------------------o--------------------------------------X------------v------
------------------------------------------------???------------X------------------------------------------------------XXXXXXXXXXX--BBB------------------X-----------------------------------------o----f------
------------------------------------------------------------XXXXXXT--------------XXXXXXX----?XXXXXX---------o------BBBBBB--------o-----------------------------------------------o---------------------f------
--B-------o------------------------------------?XXXX--------------|-----T------------------------------BBBB------------------------------------------------XXXXXXX-------------------------------------f------
--------------------------------------T------------------XXXXXXX--|-----|-------------------------------o---------------------------------o-----XXXX---------------------------------------------------f------
--------------------------X-----------|-------XXXXXXX-------------|-----|--------------------------------------------o---------------T-----------------------------------------------------------------f------
--------------------------------------|--------------BBBXBBBB-----|-----|??????---XXXXXX---------------------------------------------|-------------o---------------------------------------------------f------
m--------E----------------------------|-------------E-------------|-----|--------------------------------------------------------E---|-----------------------------------------o-----------------------X------
XXXXXXXXXXXXXXXXXXXXXXXXXXXXXXXXXXXXXXXXXXXXXXXXXXXXXXXXXXXXXXXXXXXXXXXXXXXXXXXXXXXXXXXXXXXXXXXXXXXXXXXXXXXXXXXXXXXXXXXXXXXXXXXXXXXXXXXXXXXXXXXXXXXXXXXXXXXXXXXXXXXXXXXXXXXXXXXXXXXXXXXXXXXXXXXXXXXXXXXXXXXXXX

