--------------------------------------------------------------------------------------------------------------------------------------------------------------------------------------------------------
---------------------------------------------------------------o--o-------------------------------------------------------------------------------------------------------------------------------------
--------------------------------------------------------------------------------------------------------------------------------------------------------------------------------------------------------
-----------------------------------o--------------------------------------------------------------------------------------------------------------------------------------------------------------------
--------------------------------------------------------------------------------------------------------------------------------------------------------------X-----------------------------------------
---------------------------------------------------------------o-------------------------------------?--------------------------------------------------------------------------------------------------
-----------------------------------------------------------------------------------------------------------------------o------------------------------------------------------o-------------------------
---------------------------------------------------------------------------------------------------------------------------------------------------------------------------?---------------------------v
----------------------------------------------------------------XXXXX---------XXXXX----?--------------------XXXXXXXX---------------------XXXXXXXX------------------------------------------------------f
---------------------------------------------o-----------T------XXXXX----------------XXXXXXXX------------------------------T--------------------------------------------------------------o------------f
--------------------------------------------XXXXX--------|-----------------------------------------------------------------|---------------------------------------------------------------------------f
-----------------------------------------------X---------|--XXXXX----------------------XXXX-----------XTX------------------|----oXXXXXX----------------------------------------------------------------f
-o--------------------------XXXXX------------------------|--------------------XXXXXBXX----------XXTX---|-------------------|---------------------------------------------------------------------------f
-----------------------------------XXXX------------------|--------X--XXXX------------o------------|----|-------------------|------BBBBBXBB-------------------------------------------------------------f
m-E-------------E-----------------------------------E-E--|----------------------------------------|----|------------------E|-----------------------------E-E-------------------------------------------X
XXXXXXXXXXXXXXXXXXXXXXXXXXXXXXXXXXXXXXXXXXXXXXXXXXXXXXXXXXXXXXXXXXXXXXXXXXXXXXXXXXXXXXXXXXXXXXXXXXXXXXXXXXXXXXXXXXXXXXXXXXXXXXXXXXXXXXXXXXXXXXXXXXXXXXXXXXXXXXXXXXXXXXXXXXXXXXXXXXXXXXXXXXXXXXXXXXXXXXXX
