-----------------------------------------------------------------------------------------------------------------------------------------------------------------------------------------------------------
-----------------------------------------------------------------------------------------------------------------------------------------------------------------------------------------------------------
-----------------------------------------------------------------------------------------------------------------------------------------------------------------------------------------------------------
-----------------------------------------------------------------------------------------------------------------------------------------------------------------------------------------------------------
-----------------------------------------------------------------------------------------------------------------------------------------------------------------------------------------------------------
-----------------------------------------------------------------------------------------------------------------------------------------------------------------------------------------------------------
-----------------------------------------------------------------------------------------------------------------------------------------------------------------------------------------------------------
----------------------------------------------------------------------------------------------------XXXXXX---------------------------------------------------------------------------------------------v---
-------------------------------------------------------------------------------------------------------------------XXXX--------------------------------------------------------------------------------f---
--------------------------------------------------BBB---------------------------------------------------------------------XXXXXX-----------------------------------------------------------------------f---
-------------------------------------------------T-------------------------------------------------------T---------------------------------------------------------------------------------------------f---
-----------------------------------------????----|BB------------------------XXXX-----XXXXXX-----o--XXXX--|---o---XXXXX--XXX--------------XXXX-XXXX--???-------XXXX-------------------------------------f---
-------------------------------------------------|-------------------------------------------------------|---------------------------------------------------------------------------------------------f---
-------------------------------------------------|-------------------------------o-----------------------|---------------------------------------------------------------------------------------------f---
m--------------------------------E---------------|-------------------------------------------------------|----------------------------E------------------------------E---------------------------------X---
XXXXXXXXXXXXXXXXXXXXXXXXXXXXXXXXXXXXXXXXXXXXXXXXXXXXXXXXXXXXXXXXXXXXXXXXXXXXXXXXXXXXXXXXXXXXXXXXXXXXXXXXXXXXXXXXXXXXXXXXXXXXXXXXXXXXXXXXXXXXXXXXXXXXXXXXXXXXXXXXXXXXXXXXXXXXXXXXXXXXXXXXXXXXXXXXXXXXXXXXXXX
