-----------------------------------------------------------------------------------------------------------------------------------------------------------------------------------------------------------------
---------o-------------------o---------------------------XB--B--------------------------------------------o---o---o--------------o-------------------------------------------------------------------------------
-----------------------------------------------X------o-o---------o---------X------------------------------o---------o------o--o-------o------B------------------------------------------------------------------
--------------------------o---------------------------------------------B-BX--------------------------X-BX-------------------------------------------------------------------------------------------------------
----?--------------------------------o-------------------X----------B-------------------------------------o---------------------------o-----------o-----------------o-BBXB--------------X-------o----------------
------X----o-----X-------?X?X?-o------------o--------B-----------X-----BBB-------------B-?------B-B----B-----------X---?--XX?--------------XXX-B-BB----X---------X-----------------X--------o--------------------
---------------------------------------X---------------------------------------------------X------------------------------------------------E---------o-----------BBB--------------------------------------------
-X------------------??------------------------------------------------------BB--------------X-XX---o-------B----------o--B-B---------------BB------------------------B---------------------------------v---------
----o---o-----------o------------?-o---------------oXX--------------------------------------------XXX----------------o-----o------------oo---------------------XB-XX--X------------------o-------------f---------
------------------------------------------------------B--------B----BB-------X-X------------------------X--------B---BBBB----?--------------------oB?BB------T---------o-------X---------------X-------f---------
--o----------?-----------------------o--------------o-----------X--------------T-o-------------------------------o-----T----oo-------------------------------|------------o----------------------------f---------
---o---------------B-B--B----T---XXXX---------BB---BB----------------BB----B--B|------------B--BB?--XBB-XX-BBB--XXX---B|----BX-XB-?--oBBBX------BB------X-BBB|o-----------------------------------o-o--f---------
-------------------o--------o|----o-------------------------------------------o|--------------------------------T------|o-----B-----oT--------o--------------|T----------------------------o----X--X---f---------
-----------------------------|----------------o-------------------------o------|--------------------------------|----o-|---X---------|---o-------------------||--------X-------?-----------------------f---------
m-E----E---------------------|-------------E-----------------------------------|--------E-----------E-----------|------|-------------|-----------------------||---E----------------------E-------------X---------
XXXXXXXXXXXXXXXXXXXXXXXXXXXXXXXXXXXXXXXXXXXXXXXXXXXXXXXXXXXXXXXXXXXXXXXXXXXXXXXXXXXXXXXXXXXXXXXXXXXXXXXXXXXXXXXXXXXXXXXXXXXXXXXXXXXXXXXXXXXXXXXXXXXXXXXXXXXXXXXXXXXXXXXXXXXXXXXXXXXXXXXXXXXXXXXXXXXXXXXXXXXXXXXXX
