-----------------------------------------------------------------------------------------------------------------------------------------------------------------------------------------------------------
---------------------------------------------------------------------------------------------------------------------------------X-------------------------------------------------------------------------
------------X---------o------------------------------------------------------------------------------------------------------------------------------------------------------------------------------------
----------------------------------------------------------------------------------------------------------------------?----------------------------------------------------------------------------o--X----
------------------------------------------------------------X---------------------------------------------------------------------o-----o------------------------------------------------------------------
----------------------------------------------------------------------------------------------------------------------------------------------------------------------------------------------X------------
-----------------------------------------------------------------------------------------------------------------------------------------------------------------------------------------------------------
----X--------------------------------------------------------------------------------------o---o-------------------------------------------------------------------------------------o-----------------v---
---------------------------------------------------------------------------XXX-----------------------------T----------------------------------XXXXXXX--------------------------------------------------f---
-------------------------T---------------------------------------------------------------------BBBBBBB-----|-----X-------XXXXXX-------------------------------------------------------------------o----f---
-------------------------|-------------XXXXXXX----XXXXXXXX-------------------------------------------------|-------------------------------------------------------------------------------------------f---
--------------------XXX--|----------------XXXXX---------------T-------------------------------X-XXX--------|------------------------------------------T--------------------------------X---------------f---
-------------------------|------------------------------------|------------------o-------------------------|-------???????----------------------------|--------XXXXXXXX--------------------------------f---
-------------------------|----------X?XXXXXX------------------|--------------------------------------------|-------------------X----------------------|------------------------------------------------f---
m-EE---------------------|-------E----------------------------|---------------------------E----------------|----------E--------E----------------------|-------E---------------------------E------------X---
XXXXXXXXXXXXXXXXXXXXXXXXXXXXXXXXXXXXXXXXXXXXXXXXXXXXXXXXXXXXXXXXXXXXXXXXXXXXXXXXXXXXXXXXXXXXXXXXXXXXXXXXXXXXXXXXXXXXXXXXXXXXXXXXXXXXXXXXXXXXXXXXXXXXXXXXXXXXXXXXXXXXXXXXXXXXXXXXXXXXXXXXXXXXXXXXXXXXXXXXXXX
