-----------------------------------------------------------------------------------------------------------------------------------------------------------------------------------------------------------
-------------------------------------------------------------------------------B----------------------------------------------------------------------------------------X-------------------B--------------
-?---------------------------------------X----------------------------------------o-----o------------------------------------------------------------------------------------------------------------------
--------------------------------------X----------------------------B---------------------------------o---------------X-------------o-----o----------------------------------------------------o------X-----
----------------B-------------------------------------------------------------o---------------o-------o--o-----------------------X-------------------------------------------------------------------------
------------------B--o---------------------------------------X----------------------o------------B-----------------B-------------------------------------X???-------------X--------------------------------
---------------------X-------------------X----------X------------------X-----X--?--o--------------------------------------------o----X---------------------------------X--------------o--oo----------------
------o---B------------------------------------------o----------------BXBBBBB----B-----------------------------------------------????----------------BBBBBBB------------------------------X------------v---
---------------------------o---------------X--------------------------------------------------T------oo-----------BXBBBBBX--------T------------------------------------------------------o-------------f---
------------------X--------o-------------------BBBBBB---------------------------------------BB|B-----XXB-BBB-------X----?---------|-------o---------------------------------------o---------o----------f---
----------------------------------------------------------T--o---o-o--------------------------|-T-------oX------------------------|-------------------------------------------------X------------------f---
-----------------------------------T-BBB-----BBBBB?-------|-------BBBBX---BBB--B-XBBB---B--BBB|-|-BXXXX--------????--------------B|XB----------------??---XBBBBB----X----------------------------------f---
---o----------------T--------------|---------------------T|--------oo-o----oX----------------o|-|-o----------------TX--------X----|------------------------------------------X-------------------------f---
-----------------o--|-----------o--|---------------------||--------------------------o--------|-|------------------|--------------|--------------X-----------------------------------------------X-----f---
m--E----------------|-E------------|---------E-----------||-----------------------------------|-|-----------E------|--------------|----------------------------------------------------------E---------X---
XXXXXXXXXXXXXXXXXXXXXXXXXXXXXXXXXXXXXXXXXXXXXXXXXXXXXXXXXXXXXXXXXXXXXXXXXXXXXXXXXXXXXXXXXXXXXXXXXXXXXXXXXXXXXXXXXXXXXXXXXXXXXXXXXXXXXXXXXXXXXXXXXXXXXXXXXXXXXXXXXXXXXXXXXXXXXXXXXXXXXXXXXXXXXXXXXXXXXXXXXXX
