-----------------------------------------------------------------------------------------------------------------------------------------------------------------------------------------------------------
-----------------------------------------------------------------------------------------------------------------------------------------------------------o-----------------------------------------------
---------------------------------------------------------------------------------------------------------------------------------------------------X-------------------------------------------------------
-o---------o------------------------------------------------------------------------------------------o----------------------------------------------------------------------------------------------------
----------------------------------?----------------------------------o----------------------------------------------------------------------------------------------------------------X--------------------
-----------------------------------------------------------------------------------------------------------------------------------B------X----------------------------------------------------------------
-----o--------------------------------------------------------------------o----------------------------------------------------------------------------------------------------------------------?---------
-------------------------------------------------------------------------------------------------o-------------------------------------o-----------------------------------------------------o---------v---
---------------------------------------------------------------o----------------XXXXX----------------XXXXXXBX--------------------------------------------------------o---o-----------------------------f---
--------------------------???--------------o---XXXXXXXX------------XXXXXXXXXXXX-------------------------XXXXXXX-----------XXXXXX-----------------------------------------------------------------------f---
---------------------------------------BBB------------------------------------------------XXXXXXXX----------XXXX-XXXXX----------------------------------------------------------------X----------------f---
----------------------------------------------------------XXXXXX-------------------XXXXXXX-------------------o--------------------------------------------------B----o-------X-------------------------f---
-----------------------------------------------------------------------------------------------------------XXXXXXXX---------------XXXX------XXX--o-----------------------------------------------------f---
--------------------o------XXXXXXX-----------------------------BBBBBBB-------------------------o---------XXXXX---o--------------XXXX---------?X--------------------------------------------------------f---
m-------------------------------------------E-E---------------------------E---------------------------------------------E---------------------------------------------o--------------------------------X---
XXXXXXXXXXXXXXXXXXXXXXXXXXXXXXXXXXXXXXXXXXXXXXXXXXXXXXXXXXXXXXXXXXXXXXXXXXXXXXXXXXXXXXXXXXXXXXXXXXXXXXXXXXXXXXXXXXXXXXXXXXXXXXXXXXXXXXXXXXXXXXXXXXXXXXXXXXXXXXXXXXXXXXXXXXXXXXXXXXXXXXXXXXXXXXXXXXXXXXXXXXX
