-----------------------------------------------------------------------------------------------------------------------------------------------------------------------------------------------------------
-------------B---------------------------------------------------------------------------------------------------------------------------------------------------------------------------------------------
----------------------------------------------------------------------------o--------------------------------------------------------------------------------------o---------------------------------------
-----------------------------------------------------------------------------------------------------------------------------------------------------------------------------------------------------------
-----------------------------------------------------------------------------------------------------------------------------------------------------------------------------------------------------------
-----------------------------------------------------------------------------------------------------------------------------------------------------------------------------------------------------------
-------------------------------------------------------------------XXXXX---------------------XXXXXXXX---------------------------------------------------------------------------o--------------------------
-------------------------------------------------------------------------------------------------------------------------------------------------------------XXXX--------------------------------------v---
---------------------------------------------------------------------------------------------------------o---------------------------------------------------------------------------------------------f---
-----------------------------------------------------------------BB?BBBBBT--------------XXXXXXXX-XXXXX-------------------------------------------------------------------------------------------------f---
-----------------------------------------------------------------E-------|-----------------------------------------------------------------------------------------------------------------------------f---
------------------------------------------------XXXXXXX----XXXXXXX-------|????XXXXXXXBXXX--------XXXXX---------XXXXXXXX-----XXX------------T---BBB-------XXXXXXX--o------------------------------------f---
-------------------------------------------------------------------------|-------------------------------------------o---------------------|-----------------------------------------------------------f---
-------------------------------------------------------------------------|-----------------------------------------------------------------|-----------o-----------------------------------------------f---
m----------------E-----------------------------------------------o-------|-----------------------------------------------------------------|-----------------------------E-----------------------------X---
XXXXXXXXXXXXXXXXXXXXXXXXXXXXXXXXXXXXXXXXXXXXXXXXXXXXXXXXXXXXXXXXXXXXXXXXXXXXXXXXXXXXXXXXXXXXXXXXXXXXXXXXXXXXXXXXXXXXXXXXXXXXXXXXXXXXXXXXXXXXXXXXXXXXXXXXXXXXXXXXXXXXXXXXXXXXXXXXXXXXXXXXXXXXXXXXXXXXXXXXXXX
