-----X-|T-------?----------T-M---M?--|-X-----X------|o-------|--o---o-M-B--EM----MX-|-?-B-E---B--|-T--B?-----|--M-----o---X----------?------T-BB-|--------E--MB-E-----?B--o-M-------?o---TX--X--XT------
--B------M----?-----|----E-E---T-E------B------T-----?---------------|----?--------|-----X--Bo----T------o-----?B-X--o--MT---o------M---TX---ETT-?|--Bo-B----------|X|E------X--M--E---T---E--?-T-----|-
---------T-|T----------T|-------X--|X--oMo--oo-?---------?--X-------E|-------------------o-X-------X----M--Bo-E---------E--|?--------X--------oT|---XM---E---M---o|---o---BB-o-----oE-------------?-----
--------TM--B--o|-T----------------T-|---?------------XXX----M?-------|--------T--E-E----T-T--B----o-|------------X---|-M---E------------|EM?-------------------------?---?-------BT--o--|--|---?-------
--------o----X--E-B--M-------o--|---------?--------oo---T------X?------?-?--M----M---XXT-------------E---X---------?----M--o------M-|-o---|------------|---|--?-----B-X-----T---T--o-M-----M----B-?-----
-M------?----|M----|E-T-?----------o|o-----------X-T--------T?E|-X--T---------|-X-E-oBToo----X-B--------E-----T-TX-----o--T-------M|----E---o-----------|X---M----T--------------------E-||------|------
-||-BT?---T---MM-M-----E----To----?----E--M---------------|--------E----B----?---?---M--ME-|-?---M-------?-B----|-----E--------o----?---T-------M----E|oT----E--o-B----?----Bo---------B---TT-----------
-----?---------M---T--o-------------------T-------M-T----E-----B---------Bo--oTB--o-----------E----?-------X?T-B---MM------?---M-E-E?----|-T-M-----o-------TB-|-oE-|-oMM-|---B------o---ToB--X------o--v
--T----------T|----E---T-----EE---------|--B-?oooM|E-----X?---o-----B-B---------Eo----?-o-o----B--o-----T-o-----M-o---B-M----|M-B---------M-M-----T--MT----------?----o--------E-T---B----------X-X----f
-B--?|------M-T?X---BB--?------E-To----X---------B------EB-T-------oB----------M-----M----o---E?B--------XXo----B---E----------B-----------------------M--------o---X-------T--------BTE-o--MX---X-M---f
--M-EXT------ME---E--X-EMT-------------E--T--oT|----------BMM---o|-----------M--?-o---|--E--T----------E----BE----------|-----?E-|--X-B---------------M------X---o-oX|----B---X-|-X-B--B|--B----|-T-o--f
-----?-------MM--|B-E---E--?-----------B----------|-----E----TM---MX---------oX---|--?T---------B---M--|-T-BX---E|---------|-T-EB---------|EoE-E--------X---o-E-----T---M----B---------T------X-|------f
-?---|-M----------??-o-----?--E--|--M-----E-|B-----T---|--T------BE?--T------------M|----M|--||---|--?--------oX----oB-----?------?----o--EM---|X-EMT|------------X-----------TXo-----------------M--B-f
-------E--?---ME-|---B---B--X---|------|-------E-B---X----TM----Mo----X---T--------E--M---T-|--?-E--?---?---M----Mo-X----------B---B-?-E----------X-------o-?E|-----------?MXT--------XM----o----?-o-|-f
m------------------------------------------------------------------------------------------------------------------------------------------------------------------------------------------------------X
XXXXXXXXXXXXXXXXXXXXXXXXXXXXXXXXXXXXXXXXXXXXXXXXXXXXXXXXXXXXXXXXXXXXXXXXXXXXXXXXXXXXXXXXXXXXXXXXXXXXXXXXXXXXXXXXXXXXXXXXXXXXXXXXXXXXXXXXXXXXXXXXXXXXXXXXXXXXXXXXXXXXXXXXXXXXXXXXXXXXXXXXXXXXXXXXXXXXXXXX
