--------------------------------------------------------------------------------------------------------------------------------------------------------------------------------------------------------
------------------------------------------------------------------------------------------------------------------------------------X-------------------------------------------------------------------
--------------------------------------------------------------------------------------------------------------------------------------------------------------------------------------------------------
---------------X-------------------------------------------------------o--------------------------------------------------------------------------------------------------------------------------------
----------------------------------------------------------o------------------------------------------------------------------------------------o--------------------------------------------------------
----------------------------------------------------------------------------------------------------------------------------o---------------------------------------o-----------------------------------
----------------------------------------------------------------------------------------------------------------------------------------------------o---------------------------------------------------
-------------------------------------------------------------------------------------------------------------------------------------------------------------------------------------------------------v
---------------------------------------------------------------------BBBBB-----------------T-----------XXXXBBB------------XXXX--------------------???-----------------------------------o--------------f
------------------------------------------------------XXX----------------------------------|-----o-----------------------------------------------------------------------------------------------------f
------------------------------------------------------------------------------------o------|-----------------------------------------------------------------------------------------------------------f
--B----------------------X-------------------?---------------------------------------------|---------------------------------------------------XXXXX---------------------------------------------------f
-------------------XXXX----------------------------------------?????-----------------XXXXXX|--------------------XXXXXX-----------------------BB-----X--------------------------------------------------f
------------------------------------------------------------------XXXX---------XXXXX-------|--------------------------------------------------------o--------------------------------------------------f
m-------------------------------------------------------------------E----------------------|---------------------------------------------------------------------E------------------------------E----E-X
XXXXXXXXXXXXXXXXXXXXXXXXXXXXXXXXXXXXXXXXXXXXXXXXXXXXXXXXXXXXXXXXXXXXXXXXXXXXXXXXXXXXXXXXXXXXXXXXXXXXXXXXXXXXXXXXXXXXXXXXXXXXXXXXXXXXXXXXXXXXXXXXXXXXXXXXXXXXXXXXXXXXXXXXXXXXXXXXXXXXXXXXXXXXXXXXXXXXXXXX
