-----------------------------------------------------------------------------------------------------------------------------------------------------------------------------------------------------------
--------------------------------?-----------------------------------------------------------o--------------------------------------------------------------------------------------------------------------
--------------------------------------------------------------o--------------------------------------o--------------------------------------------------------------------X--------o-----------------------
-------------------o-----X--------------------------------------------------------------------o-----------------------o----------------------------------------------------o-------------------------------
------------------------------------------B------------------------------------------------------------?-----------------------------------------------o------------------------o--------------------------
------------X--------------------------------------------------------o-----------------BBB----------------------------o-BBBBXBBB---------------------------------B--X--------------------------------------
--------------o-----------------------------------X---------------------------------o----------------------------------------------------------------------------------------X-----------------------------
------------------?--o------BB--------------------------------------------------------XXX-XX-------------BBBB---------------------------------------------X--------------------------------------------v---
-------------------------------------o-----------------------------?BBB-------------------------------------------------------------------B?BXXBBB-----------------------------------------------------f---
-----------------------o--------------o---B-BBBB----------------------o---------------------o----------o--o-------------XXXXX---X-----------------B----------------------------------------------------f---
------------------------X--------------------------T------------------------------T-----E------------------------------o------------------------o------------------------o-----------------------------f---
-----------B--------------????X-BX-------?---------|o----o-TT--BB----------BTBB-B-|----BBB--------XT----BBBB----BBBB?X???---------BXBBBBBBXBBBBBB-----------------------------------o------------------f---
-----------------------------------------------o---|-------||T--------------|-----|-----T----------|---------------------------------o---X-----------------o----------------------X--------------------f---
---------------------------------------------------|-------|||--------------|-----|-----|----------|-----------------------o---------------------------------------------------------------------------f---
m--------------------------E-----------------E-----|-------|||--------------|-----|-----|---E------|---------------------o----------------------------------o------------------------------------------X---
XXXXXXXXXXXXXXXXXXXXXXXXXXXXXXXXXXXXXXXXXXXXXXXXXXXXXXXXXXXXXXXXXXXXXXXXXXXXXXXXXXXXXXXXXXXXXXXXXXXXXXXXXXXXXXXXXXXXXXXXXXXXXXXXXXXXXXXXXXXXXXXXXXXXXXXXXXXXXXXXXXXXXXXXXXXXXXXXXXXXXXXXXXXXXXXXXXXXXXXXXXX
