-----------------------------------------------------------------------------------------------------------------------------------------------------------------------------------------------------------
-------------------------------------o---------------------------------o-------------------oo--o---------------------------------------X------------------------------------------------oX-----------------
------------------------------o-----------------------------o---------------------o-------------------o----------o-------------------------------------------------o---------------------------------------
-----------------?o---------------------------X--------------------------------------------------------------------o------------------------------o---------X----------------------------X-----------------
------------X------------------------X-----------------------------X-------------o-----------BXB--BB----------------------------------------------------X--------o-----------------------------------------
-------B--------------------B-----o-X------------------------X--------------o--------------------------------------------------X-o-----------X---?---------------B---o-----o-------------------------X-----
---------------?--o----------o------------o----o------o-------------------------------------------o----o------------X------o---------------------------o--------------------?----------------?--o----------
-----------------B---------------------------------------------------------------------XXBBBXoB------------X--------------E----------o----------------X---o?-------------------------------------------v---
-o-------------o----------B---------------------------------BX------------BBBB-XB----------------------o-------o------X?????---------------------------------T---------------------------X-------------f---
--------------------oo---o----------T----------------------B--X----------------------------------o---------BBB-----------------------------------------------|---------------X-------------------------f---
------------------------------------|----T-----?------T------------------o------------------------o--T-----------------------------------------------------o-|--------------------------------o--------f---
----X------------------------------X|B-BB|----?----B--|--o--B-XB-BT-o----B-----------XXXXX-----------|-----o--------BBBBB----------------------T--------o---B|B-------------------------X--------------f---
------------------------------------|----|-T----------|-----------|------------------------o------T--|---TT--o-----------------------X---------|---o---------|-----------------------------------------f---
------------------------------------|----|-|----------|-----------|--o--------B---------------o---|--|---||------------------------------------|-------------|------------------------------X----------f---
m-----------------------------------|----|-|----------|--o--------|--o---------------E------------|-E|---||------------------------------------|-------------|--E--------------------------------------X---
XXXXXXXXXXXXXXXXXXXXXXXXXXXXXXXXXXXXXXXXXXXXXXXXXXXXXXXXXXXXXXXXXXXXXXXXXXXXXXXXXXXXXXXXXXXXXXXXXXXXXXXXXXXXXXXXXXXXXXXXXXXXXXXXXXXXXXXXXXXXXXXXXXXXXXXXXXXXXXXXXXXXXXXXXXXXXXXXXXXXXXXXXXXXXXXXXXXXXXXXXXX
