-----------------------------------------------------------------------------------------------------------------------------------------------------------------------------------------------------------
----------------X-------------------------X------------------------B-----o---------------------------------------o-----------------------------------------------------------------------------------------
-----------------------------------------------------------------------------------------------------------------------------------------------------------------------------------------X-----------------
-----------------------------------------------------o-o----------------------------X----------------------------------------------------------------------------X-----------------------------------------
---------------------o--------------X--------------o--------------------------o-----------------------------------------------------------o-------------o--------------------------------------------------
--------------------------------------------o-----X-------?---------------------------------------X--------------------------------------------------------------------------------------------------------
-------------------------------------------------------------------------------------------------------------------------------------------o----------?---?------------------------------------------------
-------------------------------------------------o---------------------------B--------------------------------------------------------------o------------------------o----------------------------o----v---
-------o------------X------------------------------------XXX-------------------------------------------------------------------------------------??????-------------------------------------o----------f---
------------------------------------------------X---------o---------------------------------------XXXX------------------XX-----------------------------------------------------------------------------f---
-------------------------------------------------------XXXXX-------------------XXXXBX----------------------------------X--------------------B-----------------X------------X------------o--------------f---
--------------------------------------------------------XXXXXXXX-o---------------------------------------------------------------o----X------------------------------XXXXX-----------------------------f---
-------------------------BT-------------------------XXXXXX------------o-o---------------X----------------------X-----------------------------X-------------------------------------------X-------------f---
--------------------------|XXXX-------BBB----X------------o-------------------XXXo--------XXXXXXX-----------XXXXX?------------XXXo---------------------------------------------------------------------f---
m-----E---E---------------|-------------------------------------E----------------------------------------------------------------------------------------o-E-E-----------------------E-------------E---X---
XXXXXXXXXXXXXXXXXXXXXXXXXXXXXXXXXXXXXXXXXXXXXXXXXXXXXXXXXXXXXXXXXXXXXXXXXXXXXXXXXXXXXXXXXXXXXXXXXXXXXXXXXXXXXXXXXXXXXXXXXXXXXXXXXXXXXXXXXXXXXXXXXXXXXXXXXXXXXXXXXXXXXXXXXXXXXXXXXXXXXXXXXXXXXXXXXXXXXXXXXXX
