-----------------------------------------------------------------------------------------------------------------------------------------------------------------------------------------------------------
-----------------------------------------------------------------------------------------------------------------------------------------------------------------------------------------------------------
------------------------------------------------------------------X-----------------------------------------------XBBBBBBX-----------------------B----------------------------------------o----------------
---o------------X--------------------------------------------------------------o-----------------------------------------o------------------------------------------X-----------------------------o--------
-------------------------------------------------B------------------------------X----------------------------BBBX-B--------------------------------------------------------------------------o-------------
---------------------------------------------------------XBB-X-----------------------------------------X---------------------------------------------------------------------------------------------------
-----------------------X--------------o-----------------------------o---X-----------X----------------------BBBBBBB--------------o------------------------BBBB-----------------X----------------------------
---------------------------------------------??X--------BBB-?---------???------------BBBBBBB--------------------------------------------------------------o--------------------------------------------v---
-----------------------------X------------------B---T---------------?-----------------------Xo-T--------?????-----------------------X--------------BBBBBBBB--------------------------------------------f---
--------------------T-------------------------------|---------o-----------------------T--------|-----------------------------------------------------------o---------BBBB------------------------------f---
--------------------|------------------------B------|-----------------------T---------|--------|------------T-----------------------o------------T----------------------------X------------------------f---
-----------------BXB|BB---------------o-BBBBBBBBB--B|BX--------TT?BBBBXB-BB-|-----B--B|B----??X|B-X?X??-?-?-|------------------BBB-------T-BBB---|XBB-BB--------BBBBBBB--------------------------------f---
--------------------|---------o---------------------|----------||-----------|---------|-T------|------------|---ToT-----------T----------|-------|---T-------------------------------------------------f---
--------------------|---------o---------------------|----------||-----------|-------?-|-|------|------------|---|-|-o---------|------X---|-------|---|------o------------------------------------------f---
m-------------E-----|-------------------------------|----------||----E----E-|---------|-|------|------------|---|-|---E-------|----------|-------|---|---------E---E-----------------------------------X---
XXXXXXXXXXXXXXXXXXXXXXXXXXXXXXXXXXXXXXXXXXXXXXXXXXXXXXXXXXXXXXXXXXXXXXXXXXXXXXXXXXXXXXXXXXXXXXXXXXXXXXXXXXXXXXXXXXXXXXXXXXXXXXXXXXXXXXXXXXXXXXXXXXXXXXXXXXXXXXXXXXXXXXXXXXXXXXXXXXXXXXXXXXXXXXXXXXXXXXXXXXX
