-----------------------------------------------------------------------------------------------------------------------------------------------------------------------------------------------------------
------------------------------------------------------------------o-------------------------------------------------------------X-o-----------------------o-----------------------o------------------------
---------------------------------------o----------------------------------o----------------------------------------------------------------------------------------------------------------o---------B-----
---------------------------------o------------------------------------------------------------------------?------------------------------------------------------------------------------------------------
-------------------------------------------o-----------------------------------------------------------------------------------------------------------------------------------------------X--------o------
---------------------------------B-----------------------------------------X--------------------------------o----------------o--o------o-----o-------------------------------------------------------------
----------------------------B------------------------X-----------o-----------------------------------------------XXXXXX-----------------------------------------o-------o-------------X-------o------------
---------X---------------------------------------------o---------------X-------o------------------oX---------------------------------------------o----------------------o------------------------------v---
--------------------------------o-----------------XXXX---To------------------------------------------------------XXXX--------------------------------------B------------X------------------------------f---
--------------------------X----------------X-------------|o------------------XXXXXX----------------------------------------------------------------------------------------------?---------------------f---
-----------------o---------------------------------------|-----------------------------------------------X---------------------------------------------------------------------------------------------f---
----------------------------XXXXXXXB--?B???o-----XXXX-X-X|XXXX---------X-----BBBBB--XXX----XXXX---oo----BBBBBBB-------XXXXXXX-------o?XXXX-----XXX-B--------------------B------------------?-----------f---
-o-----------------X-------------------------------------|-------o-------------------------------------T---------X------------o--------------------------------T---------o----o------------------------f---
-----------------B---------------------------------------|----------------X---o------------------------|-----------------------------?-------------------------|---------------------------------------f---
m-E--------------E---------------------------------------|------E--------------------------------------|---------E-----------------------------E---------------|-----E---------------------------------X---
XXXXXXXXXXXXXXXXXXXXXXXXXXXXXXXXXXXXXXXXXXXXXXXXXXXXXXXXXXXXXXXXXXXXXXXXXXXXXXXXXXXXXXXXXXXXXXXXXXXXXXXXXXXXXXXXXXXXXXXXXXXXXXXXXXXXXXXXXXXXXXXXXXXXXXXXXXXXXXXXXXXXXXXXXXXXXXXXXXXXXXXXXXXXXXXXXXXXXXXXXXX
