-----------------------------------------------------------------------------------------------------------------------------------------------------------------------------------------------------------
-------------------------------------o------------o-----------------------------------------------------------------------------BBB------------------------------------------------------------------------
------------------------------------?---------o-----------------------X---o---o--X----B---------------------------------------o---------------------------------------------------o------------------------
-----------------------------------------------?-----------------------------------------------------------------------------------------------------------------------------------------------------------
--------------------------o---------o-------Xo-------------------------------------------------------------------------------------------BB-BBBBB-------------------------------------o--------------------
------------------------------------------------BBBBB------------------o-----BBBBBB--------BBB----------------------------------BBBBB-------------------B---------------?----------------------------------
-------o--------X-------------------------------------------------------------------------------------B?--------------o---------------------------------------X--------------------------------------------
------------------------------------------------BBBB-----------------------BBBBBB-------------------------------------------BBBB------------------------BBB--------------------B-----------------------v---
------o---------------B------------------------------------o------------------------------------------BB---X--------------------BBBB---BXB------------------X---------------o--------------------------f---
--------------------------------------------BBBB----T--------------------------T----------?B????-X----------o------X--------------------------------o--------------------------------------------------f---
-------------------o----------------X---------o-----|--------------------------|-----------------------o-----------------------------------o----------------------------o------------------------------f---
----------o--XB-BBBB----------B-X--------?--------BB|X-------------?X????-XBBBB|BB-----TBBBB---o------BBBBB--------BB-----BBBBBBBB---BXBB----------o----XXXBBBBBBB--B-BBXBBX---------------------------f---
-----------------------o----------------------------T--------------------------|-------|o-------------------------T-------------------------T-------------------------------o--------------------------f---
----------------------------------------------------|-o------------------------|-------|-----------------------B--|----------------o--------|------------------------------------------------o---------f---
m--------------------------------------------E------|--------------------------|E------|--------------------------|-------------------------|--E-------------------------------------------------------X---
XXXXXXXXXXXXXXXXXXXXXXXXXXXXXXXXXXXXXXXXXXXXXXXXXXXXXXXXXXXXXXXXXXXXXXXXXXXXXXXXXXXXXXXXXXXXXXXXXXXXXXXXXXXXXXXXXXXXXXXXXXXXXXXXXXXXXXXXXXXXXXXXXXXXXXXXXXXXXXXXXXXXXXXXXXXXXXXXXXXXXXXXXXXXXXXXXXXXXXXXXXX
