-----------------------------------------------------------------------------------------------------------------------------------------------------------------------------------------------------------
------------------------------------------------------o----------X-------------------------------o-------------------------------------------------------------o-------------------------------------------
------------------------------------------------------------------------------------------------------------------------------X--------XXBXB--------------------------------------------------------?------
------------------------o-----------------------------------o--------------------------------------------------------------------------------------------------------o--o----------------------------------
----------------------------X-----o-------X-----------------------------------BB---?----------o--------------------o------------------o-------------------------------------------o------------------------
-o--------------------------------------------o-----------------B------------------------------BBB----------X----------------B-----------------------------------BBBXBBB-----------------------------------
-------------------------------------o----------------------?----------oo-----------------------------------o----------------------oXBBBBBBB------------------------?-----------o--------------------------
-----------------------X----------BB---------------------o--------------------B---------------------------------X---BBBBB-------------------o-----------X-------------------X--------------------------v---
--------o-----------------------------------?-----------X-----------BBBBBB?BBB---o-------------BBB--------------------------------------------------------------------X--------------------------------f---
--------------------------------------------------------BBBB--o----------------------BBBB-------------------------------------------X?????--------------------BXB-BB-----------------------------------f---
------------------------------------------------------------------T------------------------o-------------o-------------------------------------o-------------------------------------------------------f---
----o---------------B-B--T----------X--------BBBXBo-BBBXBBB-------|BXBB?BBB----o-?XX-TBBB----BBBBBB--------X-----BBBBBBBB----?X????X?----------------------???????X------------------------o-----------f---
-------------------------|--------------------------------------T-|-----------T------|-------------------------------------------------------------------------------------o---?-----------------------f---
-------------------------|---o------o---------------------------|-|-X---------|------|-----------------------------------------------------------------------------------------------------X-----------f---
m------------------------|-------E--------------------------E---|-|--------E--|E-----|---------------------------------------------------o----------------------------E--------------------------------X---
XXXXXXXXXXXXXXXXXXXXXXXXXXXXXXXXXXXXXXXXXXXXXXXXXXXXXXXXXXXXXXXXXXXXXXXXXXXXXXXXXXXXXXXXXXXXXXXXXXXXXXXXXXXXXXXXXXXXXXXXXXXXXXXXXXXXXXXXXXXXXXXXXXXXXXXXXXXXXXXXXXXXXXXXXXXXXXXXXXXXXXXXXXXXXXXXXXXXXXXXXXX
