-----------------------------------------------------------------------------------------------------------------------------------------------------------------------------------------------------------
---------------------X----------------------------------------------X----------------------------------------------o---------------------------------------------------------------------------------------
---------------------------------------------------------------------------------------------X-------------------------------------------------------------------------------------------------------------
-----------------------------------------------------------------------------------------------------------------------------------------------------------------------------------------------------------
------------------------------------------------------------------X--------------------------------------------------?-------------------------X-------------------------o---------------------------------
-------------------------------------------B---------------------------------------------------------------------------------------------------------------------------------------------------------------
----------------------------------------------------------------------------------X------------------------------------------------------------------o-----------------------------------------------------
----------------------------------------------------------------------------------------------------------------------------------------o--------------------------------------------------------------v---
-------------X-------------------------------------------------------------------------------------XXXXXXXX-------XXXXXXXX--XXXXXXX------------------------------------------------------X-------------f---
-----------------------------------o-----------o------------------B------XXXXXX--------XXXXXXX----------------------------------------XX----XXXXXXX----------------------------------------------------f---
--------?-------------------------------------------------------------?-----------------------------o--------------------------------------------------------------------------------------------------f---
-----------------XXXX-------------------------------------------------------------------------------------------------------------------o-------------------------------------------?------------------f---
------------------------------------------------XXXXXX-BBBBBBB--X-T--------------------XXXXXXBX---------------o---------------------------------------XX---X-------------------------------------------f---
----------------------------------------XXXXXX--------------------|---------------------------------------------------------------------------????-----------------------------------------------------f---
m-------------------------------E---------------------------------|------------------------------------------------------------E--------------------E--E-----------------------------------------------X---
XXXXXXXXXXXXXXXXXXXXXXXXXXXXXXXXXXXXXXXXXXXXXXXXXXXXXXXXXXXXXXXXXXXXXXXXXXXXXXXXXXXXXXXXXXXXXXXXXXXXXXXXXXXXXXXXXXXXXXXXXXXXXXXXXXXXXXXXXXXXXXXXXXXXXXXXXXXXXXXXXXXXXXXXXXXXXXXXXXXXXXXXXXXXXXXXXXXXXXXXXXX
