-----------------------------------------------------------------------------------------------------------------------------------------------------------------------------------------------------------
---------------------o------------------------------o--------------------------------------------X-----------------------------------------------------------------------------------------X---------------
---------------------------------------------------------------------o------------------------------------------------------------------------o-----o----------o-------------------------------------------
-----------------------------------------------------------------o-----------------------------------------------------------------o-----------------------------------------------------------------X-----
-X--------------X----------o----------------------------------------------------------------o--------o------------------------------------------------------------------X----------------------------X-----
--------X-------------o-------?------X--------------???X?--------------------------------------------------o-----------------------------------------------------X----------------------o------------------
-o------------o-----------------------o---o--------------------o------------------------------o----------?-------------o-------XXX--------------------------X-------------X---------B----------------------
-----------------------------oo-------------?o------?-----X--o---------X-XXXXXX-----------BBXBXB----------------------------------XXXXX----------X-----------------o---X----------------o---------o----v---
-----------?-----------------------o------------o-------o---------------------------------------------------------o--------------------------------------XXXXX-----------------------------------------f---
----------------------------------X-----------o---XXXX------------------------------------------------------X---------------------------------X--------------------------------------------------------f---
---------o------------------------------------------------------------o-------------------------------------------------------XBXX------------------o--------------------------------------------------f---
------------XX----XXXX-----------XXX------------XXX-------T-XXXX-----XXX-BBBBBB---o-----XXXXXX-XXXXXXXXX------------------XXXXX---BBB-----XXX---XXXX--XXXXXXX--------X---XXXXX?X----------------------of---
----------------------------------------------------------|------------o-----------------o------------o------------------o----------X----------------------------------------X-------------------------f---
----------------------------------------------------------|---------------------------------------------------------o-----------X------------------------------------------X---------------------o-----f---
m-E--------E---E------------------------------------------|---------------------------E-------------------------------------------------------------------------------------------E--------------------X---
XXXXXXXXXXXXXXXXXXXXXXXXXXXXXXXXXXXXXXXXXXXXXXXXXXXXXXXXXXXXXXXXXXXXXXXXXXXXXXXXXXXXXXXXXXXXXXXXXXXXXXXXXXXXXXXXXXXXXXXXXXXXXXXXXXXXXXXXXXXXXXXXXXXXXXXXXXXXXXXXXXXXXXXXXXXXXXXXXXXXXXXXXXXXXXXXXXXXXXXXXXX
