-----------------------------------------------------------------------------------------------------------------------------------------------------------------------------------------------------------
-----------B-------o--------------o----------------------------------X-------------------------------------------------------------------------------------------------X-----------------------o-----------
-----------------------------------------------------------------------------------------------------------------------------------------------------------------------------------------------------------
----------------------------------------------------------?------------------------------------------------------------------------------------------------------------------------------------------------
----------------------------------------X-----------------------------------X----------------------------------------E----------------------------------------------------------o--------------------------
--------------------------------------------o--------------------------------------------------------------BBB-BBXBBBBX-------o-------------o---------------------------------X----------------------------
---------------------------------------------------------------------------------------------------X---------------X--------------------o-------------------------------------------------o----------------
--------------------------------------------------------------------------------------------------------------------------------B?BBBB-----------------------------------------------------------------v---
---------------------------------------------------------------------------------------------------------------------o-----------------o--------------------------------------------------------o------f---
--------------------------------X----------------------------------------------------------------------BBB-BBBXB------o-------------------------------XXXXX--------------------------------------------f---
-----------------------------------T--------o-----------------X-----------T----------------------------------------------------------------------------B-----------------------------------------------f---
--------------------------BBB---BBB|BBB---XBB-----------------BBB----????T|-XXXXX----BBBBBBBB------o-???????-----BBB--BBB-----BBBBBXBB--------X------------------------------------o------------------of---
--------X-------o------------------|-----o-------------T?----------------||---------------T-----------------------------------------------------------------------------------------------------?------f---
-----------------o-----------------|-----------?-------|-----------------||o--------------|---------------------------------------------o--------------------------------------------------------------f---
m-E-----E-------------------------E|--------E----------|-----------------||---------------|-------------------------------------E----------------------------------------------------------------------X---
XXXXXXXXXXXXXXXXXXXXXXXXXXXXXXXXXXXXXXXXXXXXXXXXXXXXXXXXXXXXXXXXXXXXXXXXXXXXXXXXXXXXXXXXXXXXXXXXXXXXXXXXXXXXXXXXXXXXXXXXXXXXXXXXXXXXXXXXXXXXXXXXXXXXXXXXXXXXXXXXXXXXXXXXXXXXXXXXXXXXXXXXXXXXXXXXXXXXXXXXXXX
