-----------------------------------------------------------------------------------------------------------------------------------------------------------------------------------------------------------
-----------------------------------------------------X--------------------------------------------------------------------------X-----------------------o--------------------------------o-----------------
----------------------------------------------------------X--------------------------------------------------o-------B----------------------------o---------------------------------X----------------------
-------------------------------------------X---------------------------------------------------------?-----------------o----------------------------X--------------------------------o----------o----------
-------------?---o----------------------------------------------o------------------------------------------------------------------------------------------------------------------------------------------
---------?--o-----------------------------------------------o---------------------------o---------X------------BBBB-------------------------o----------------------------------------X---------------------
--------------------------------------------------------------------------------------------------------o------------------------------------B-o------------------------------X----------------------------
--------------------------------????X------?-------------BBBBBXBB----------------------BBBBB------------------------------------BBBBXB-----------BBB--------------------X-----------------------B------v---
---------------------------------o-----T------------------------------------BBB--------------o-T--------------BBBB?-----T-------------------o---o----------------------X-------------------------------f---
-----X----------------XX-------o-------|-------------------BBBBBB------------------------------|-------o---BBB----------|-----------------------------------------o------------------------------------f---
---------------------------------------|-------------------------------------------------------|------------------------|------------------------------------------------------------------------------f---
-------------------------------BBBBBB-B|BBBBBB--XBBBBBBBBBBBBXBB-------XXXXB---------BBB----B?X|B-X?X??--???????---B?BBB|BB-BXBBB?B---BBB------BB?BBBBBX-o----?-????---------------------------o-------f---
---------?-------------------------o---|------------------------------------------------T------|------------------------|------------o----------o---------o--------------------------------------------f---
---------------------------------------|--------------o---------------------------------|------|------------B-----------|----------------------------------o-----------------------------------------o-f---
m--------------------------------------|------------------------------------------------|------|------------------------|--------------E-------------E--------------------------------E------------E---X---
XXXXXXXXXXXXXXXXXXXXXXXXXXXXXXXXXXXXXXXXXXXXXXXXXXXXXXXXXXXXXXXXXXXXXXXXXXXXXXXXXXXXXXXXXXXXXXXXXXXXXXXXXXXXXXXXXXXXXXXXXXXXXXXXXXXXXXXXXXXXXXXXXXXXXXXXXXXXXXXXXXXXXXXXXXXXXXXXXXXXXXXXXXXXXXXXXXXXXXXXXXX
