-----------------------------------------------------------------------------------------------------------------------------------------------------------------------------------------------------------
-----------------------------------------X-----------------------------------------------------------------------------------------------------------------------------------------------------------------
----------------------------------------------------------------------------------------o------------------------------------------------------------------------------------------------------------------
--------------------------------------------------------------------------------------------------------------------------------------------------------------------o--------------------------------------
---------------------------------------------------------------------o-------------------------------------------------------------------------------------------------------------------------------------
-----------------------------------------------------------------------------------------------------------------------B-----------------------------------------------------------------------------------
----------------------------------------------------------------------------------o-----------X------------------------------------------------------------------------------?-----------------------------
---------------------------------------------------------------------------------------------------------------------o------------------------------------------------------------o--------------------v---
--------------------------------------------------T----------XXXXXXX--------------------------------XXXXX--------------?XXXXXXX-------XXXXXXXB------o--------------BBBBBB------------------------------f---
--------------------------------------------------|------------------------XXXXX--------XXXXXXX------------------------XXXXXXXX----------------------------------o-o-----------------------------------f---
-----------------------------XXX------------------|----------------------------------------------------------------------------------------------------T------------------------o----o-----------------f---
------------------------------------------------B-|--------o-----------------------------------------XXXX----------------------------------------------|----------XXXXX--------------------------------f---
---------------------------XXXXX------------------|--------------------------------------------------------------------------XXXXXXXX---------------BBT|BB-----o---------------------------------------f---
------------------------------------XXX-----------|--------o-------------------------------------------------------o--XXXXXXXX------------------------||--------------------------------o--------------f---
m-----------E-----------------------o-------------|-----------------------------o----------------------------E--EE------------------------------------||--E--------------E-------E------------------E--X---
XXXXXXXXXXXXXXXXXXXXXXXXXXXXXXXXXXXXXXXXXXXXXXXXXXXXXXXXXXXXXXXXXXXXXXXXXXXXXXXXXXXXXXXXXXXXXXXXXXXXXXXXXXXXXXXXXXXXXXXXXXXXXXXXXXXXXXXXXXXXXXXXXXXXXXXXXXXXXXXXXXXXXXXXXXXXXXXXXXXXXXXXXXXXXXXXXXXXXXXXXXX
