-----------------------------------------------------------------------------------------------------------------------------------------------------------------------------------------------------------
-------------X---------------------B------------------------o----------------------------o-------------------------------------------------------------------------------------------o------------o--------
------------------------------------------------------------------------------X-------------------------------------------------------X---------o--------------------------------------o-------------------
-----------------------------------------------------------------------------------------------------------------------------------------o---------X---------------------------------------------X---------
-------X----o-------------------o------------------X------o-------X---------B-------------------------X----------------------------------------X-----------------------------------------------------------
-----------------------X------------------X------------------------X--------------X-X------------------------------B-------------------------------------????-------------------X--------------------------
-o-----------------------------------------------------------------------------o----------------o---------------X-------------X----------------------------------------X---------o-------------------------
---------o------------B----------------------------------------------------XBo--------o------------------------X----------------------------o--------BBBBBXB----------------------------o--------------v---
----X-X---?------?---------------o-------X--------------------------X-----------------------------------------?--oBBBBBBBB------------------BB---------------------------------------------------------f---
-------------------o---------------------------???X------BBBBBBB-------------------------------------BXXXBBB------------------------o------------------------------------------------------------------f---
--------------------------B-------------------X--------------------------------T----------------------------------------------------T-----------------------------o-------------------------o---X------f---
-------X------------XBB--------XBXB-XBX--------BBB-----B?B-----XBBB----T---BBBX|-????----------BBB-XXXX---o----????-----------------|--o---T--BBB--XX??----BBBBB---------------------------------------f---
------------o--------------o-------------------------------------------|-------T-------T------T----o---------------T----------------|------|--------------------------------------------o----B---------f---
-----------------------------------------------------------------------|-------|---?---|------|-o------------------|----------------|------|--------------------------------------------------------?o-f---
m----------------------------------E-----------------------------------|-------|------E|------|-------------E------|----------------|------|--------------------------------------------------E--------X---
XXXXXXXXXXXXXXXXXXXXXXXXXXXXXXXXXXXXXXXXXXXXXXXXXXXXXXXXXXXXXXXXXXXXXXXXXXXXXXXXXXXXXXXXXXXXXXXXXXXXXXXXXXXXXXXXXXXXXXXXXXXXXXXXXXXXXXXXXXXXXXXXXXXXXXXXXXXXXXXXXXXXXXXXXXXXXXXXXXXXXXXXXXXXXXXXXXXXXXXXXXX
