-----------------------------------------------------------------------------------------------------------------------------------------------------------------------------------------------------------
---------------------------------------------------------------------------------------------------------X-------------------------------------------------------------------------------------------------
-----------------------------------------------------------------------------------------------o-----------------------------------------o----------X----------o------------?------------------------------
------------------------------------------------------------------------------------------------o------------------------------------------------------------------------------------o---------------------
-----------------------------------------------------o------------------------------------------------------------------------------------------------------------------------------------------------o----
------------------?---------------o---------------------------------------------------------------------------------------------------------------------------------------o---------X----------------------
----------------X---------------------------------------o--------------------------------------------------------------------------------------------------------------------------------------------------
---------------------------?---------------------------------------------------------------------------------?-----------------------------------------------------------------------------------------v---
------------------------------------------------------------XXXX------------------X-XX?XXX------------------------------XXXXXXXXXXX---T----------------------------------------------------------------f---
------------------o-------------o--XXXX------------------------------------------------------------------------------XXXXXX-----------|--------------------BBXB----------------------------------------f---
--------------------X---------------------------------------------------??????B-----------------------------------------------------o-|--------XXXX----------------------------------------------------f---
------------------------------------------XXXXX----------------------X--------------o--XXXXX--T-----------------XXXXX------------o----|----------B---------------------------------o-------------------f---
-----------------------------------------------XXX?X------------XXXXXX------------------XXXX?X|--------------------XXXXX--------------|-------------o---------------------X----------------------------f---
-------------------------------------------------------XBBB---BBBBBBB-------------------------|--------------------X------------------|---------------------???????------------------------------------f---
m-E---------E---------------------------------------------------------------------------------|-----------------------E--------E------|-----------E----------------------------------------------------X---
XXXXXXXXXXXXXXXXXXXXXXXXXXXXXXXXXXXXXXXXXXXXXXXXXXXXXXXXXXXXXXXXXXXXXXXXXXXXXXXXXXXXXXXXXXXXXXXXXXXXXXXXXXXXXXXXXXXXXXXXXXXXXXXXXXXXXXXXXXXXXXXXXXXXXXXXXXXXXXXXXXXXXXXXXXXXXXXXXXXXXXXXXXXXXXXXXXXXXXXXXXX
