-----------------------------------------------------------------------------------------------------------------------------------------------------------------------------------------------------------
-----------------------------------------------------------------------------------------------------------------------------------------------------------------------------------------------------------
----------------------------------------------------------------------------------------------------------------------------------------------------------o------------------------------------------------
-----------------------------------------------------------------------------------------------------------------------------------------o-----------------------------------------------------------------
-------------------------------------------------------------------------o---------------------------------------------------------------------------------------------------------------------------------
-------------------------o----------?----X-----X---------------------------------------------------------o----------------------------------------------?--------------------------------------------------
-------------o---------------------------------------------------------------------------------------------------------------------------------------------------------------------------------------------
-------------------------------------------------------------------------------------------------------------------------------------------------------------------------------------------------------v---
--------------------------------------------------------------------------------XXXXXX-------------------------------------------XXXXX---------BBBBBBBB------------------------------------------------f---
---------------o------XXXX-------------------X------XXXXX--------------------------------------------XXXXXXX------------?B?????------------------------------------------------------------------------f---
-------o----o---------------------o----XXXXXX-----------------------------------------------------------------BBBBBBB---XXXXXXX------------------------XXXX--------------------------------------------f---
------------------------------------------XXX------------------------------------------------------------------BBBBBBB-???????o------------------------------------------------------------------------f---
---------------------------------o--------------------------------------------------------------------T---------------------------------------------------------------------o--------------------------f---
------------------------------------XXXXXXXX----------------------------------------------------------|--------------------XXXXXXXX--------------------------------------------------------------------f---
m-----------------------------------------------------------------------------------------------------|-----------------------------------E--------------EE--------------------------------------------X---
XXXXXXXXXXXXXXXXXXXXXXXXXXXXXXXXXXXXXXXXXXXXXXXXXXXXXXXXXXXXXXXXXXXXXXXXXXXXXXXXXXXXXXXXXXXXXXXXXXXXXXXXXXXXXXXXXXXXXXXXXXXXXXXXXXXXXXXXXXXXXXXXXXXXXXXXXXXXXXXXXXXXXXXXXXXXXXXXXXXXXXXXXXXXXXXXXXXXXXXXXXX
