-----------------------------------------------------------------------------------------------------------------------------------------------------------------------------------------------------------
-------------------------------------------X--------------------------------------------------------------------------------B-------------------------------------------------------------o----------------
---------------------------------------------X--------------------------------------------------------------------------------------------------------------------o----------------------------------------
----------------------------------------------------------------------------------------------------X----------------------------o----------------------------o--------------------------------------------
-------------------------------------------------------------------------------------o-------------------------------------------------------------o-------------------------------------------------------
--------------------------------------------------------------X--------------------------------------------------------------------------------------------------------------------------------------------
---------------------------o----------------------------------------------------------------------------------------------------------?---------o-----------------------------------o----------------------
-----------------------------------------------------------------------------------o----E-------------------------------------------------------------------------------------------------------o------v---
------------------------------------------------------XXXX----o---------------o---XXXXXXXX---------------------------------XXXXX----------------------------X--------?------------------------------B--f---
--------------------------------------B--------------------o-------------------------------------o-------XXXXXXX-------------------------o-????-------o------------------------------------------------f---
---------o------------------------------------------------------------------------------T----------------XXXXXX------------------------------------o---------------------------------------------------f---
----------------------------------------------X----XXXXX---------XXXXX------------------|-------T----------------------XXXX-----------------------------------------------------------?----------------f---
---?------------------------------------------------------------------o-------XXXXX?X---|-------|---------------------------------------------------------------XXX------------------------------------f---
------------------------------------------o-------------------XX------------------------|-------|----------------------------X---------------------------------XXXXXXXX--------------------------------f---
m------------------------------E--------------------------------------------------------|-------|------------------------------------------------------------------------------------------------------X---
XXXXXXXXXXXXXXXXXXXXXXXXXXXXXXXXXXXXXXXXXXXXXXXXXXXXXXXXXXXXXXXXXXXXXXXXXXXXXXXXXXXXXXXXXXXXXXXXXXXXXXXXXXXXXXXXXXXXXXXXXXXXXXXXXXXXXXXXXXXXXXXXXXXXXXXXXXXXXXXXXXXXXXXXXXXXXXXXXXXXXXXXXXXXXXXXXXXXXXXXXXX
