-----------------------------------------------------------------------------------------------------------------------------------------------------------------------------------------------------------
-------------------------------X-----o---------------------------------------------------o------------------------X--------------------------------o----------o----------o-----------o---------------------
--------------------o------------o---------------------------------------------------------------------------o-o-----------------o------------------------------o------------------------------------------
-------------o--------o---------------------------------o--------------------------------------------?-----------------------------------------------------------------------------------------------------
-----------?---o------------------------------------------------------------o------oX-------------------o-------------------------o-----------------------------------------------------o------------o-----
-------------------------------------o-------------------------X----------X----------o------------o----?------o----X-o------------------------------B-------------------------X---------o------------------
---------------------------B------------o------------------------o----B----------------------------------------------------------------------------o---------o------o--------------?-----------------------
------------------B--X-----------o------------------------------------o--------------------------------oo----?------------X---------B-----------------------------------------------------------o------v---
---------X-------o--------o------------------------------o-------------X--------------------------------------------------o--------------------------------B---------------X---------------------------f---
-----------------------------------------------------------X------------------------------------T------------o----------X---------------------------------------?--------o-----------------------------f---
-----------------------------------------------o-o--------------------------------------o-------|-------------------------oB----X---------------T------------B--------X---------o----X----o------------f---
------------B------------T-----?-----------T------X----------X---------X-------------------T----|---------------------------------------T----T-o|--------------B--------?----------------B-------------f---
-------------------------|-------------o---|-----------------------------T-----------------|----|o---------------T----------------------|----|--|--------------T---------------X-----------------------f---
-------------------------|-----------------|-----------------------------|---------------o-|----|----------------|----------------o-----|-o--|--|--------------|-------o------X------------------------f---
m-o----E-----------------|---------------E-|---------------------E-------|---------E-------|----|----------------|----------------------|----|--|-E-------o----|---------------------------E-----------X---
XXXXXXXXXXXXXXXXXXXXXXXXXXXXXXXXXXXXXXXXXXXXXXXXXXXXXXXXXXXXXXXXXXXXXXXXXXXXXXXXXXXXXXXXXXXXXXXXXXXXXXXXXXXXXXXXXXXXXXXXXXXXXXXXXXXXXXXXXXXXXXXXXXXXXXXXXXXXXXXXXXXXXXXXXXXXXXXXXXXXXXXXXXXXXXXXXXXXXXXXXXX
