-----------------------------------------------------------------------------------------------------------------------------------------------------------------------------------------------------------
-----------------------------------------------------------------------------------------------------------------------------------------------------------------------------------------------------------
-----------------------------------------------------------------------------------------------------------------------------------------------------------------------------------------------------------
-----------------------------------------------------------------------------------------------------------------------------------------------------------------------------------------------------------
-----------------------------------------------------------------------------------------------------------------------------------------------------------------------------------------------------------
-----------------------------------------------------------------------------------------------------------------------------------------------------------------------------------------------------------
--------------------------------------------------------------------XXX------------------------------------------------------------------------------------------------------------------------------------
--------------------------------------------------XXXX---------------------------XXXXXX--------XXXXXX--------------------------------------------------------------------------------------------------v---
----------------------------------------------------------------------------------------------------------------XXXXXXX--------------------------------------------------------------------------------f---
--------------------------------------------------------------------XXXXX------------------------------------------------------------------------------------------------------------------------------f---
-------------------------------------------------------------------------------------------------------------------------------------------------------------------------------------------------------f---
----------------------------------------------T---XXXXXXX-----------????--------XXXXX------XXXXXXXX-------------XXXX----T------------????--------XXXXXX-----BBBBB--------------------------------------f---
----------------------------------------------|---------------------------------------------o---------------------------|------------------------------------------------------------------------------f---
----------------------------------------------|-------------------------------------------------------------------------|------------------------------------------------------------------------------f---
m--------------------E-E------------E---------|-------------------------------------------o-----------E-----------------|---------------------o--------o-----------------------------------------------X---
XXXXXXXXXXXXXXXXXXXXXXXXXXXXXXXXXXXXXXXXXXXXXXXXXXXXXXXXXXXXXXXXXXXXXXXXXXXXXXXXXXXXXXXXXXXXXXXXXXXXXXXXXXXXXXXXXXXXXXXXXXXXXXXXXXXXXXXXXXXXXXXXXXXXXXXXXXXXXXXXXXXXXXXXXXXXXXXXXXXXXXXXXXXXXXXXXXXXXXXXXXX
