?---------|------------------|T?-M--------M---------M-----B----M--------MTo----------T-------X--B---T----------|--------B----|M--B-----To-B--o-E-----M-----X----M--T|T---o--------o-M---------T-B---o--o
o|---T---?--o-o-----------------E-----------------M-------|-----------T---o----?------||--|-------|---?--------|---------B---MT-oM--|---------|M-E-T----T------M------oT---T------M------------T--T-T--B
|---?-------?-X---?-M---o------TBT-|----M---T?--?-||--?oT-------oX--?-E-------?------BX-X--M-?------M-To-X-----B--------|-TMMB-----------T---E-T--|---T--------B---|B----|----T----------------|-MXE---o
E?----?---T------T----------------ET-------?-----T-oX--M-----M|M-------M----B-----------|----E---T|---------|----------B---|--M-----T---o---------TX--X-?---o---------E|------|EM|---------o--o-BT-----M
XB-T--XX----------EX-T--|o-----------EB------------X---|-M---T-M-----BoM-------MB---------BB--E-------T-----|----TT-?-------M-----------To--------|---MM---X----X?----?-|oo-----X---T--?-------X------o-
X----------B-----T-E-T---EX---X---------------M--------?----------------MEM-------E--|?-------MB---------o-----?---oX|--------E-?----?--|T-X-----MX-T-o------o---oE-M---|-TT--E|---B------X------M-B--EX
oo----o----BXT---T-------T-T--||---E||------B-|-------T-----------------T?B----E---M-o--|B---B---------X--------?--Eo--T-----|-X-------?-M--o------T-?o----E|?-B--M--------XEB|-----?---E--|--X-??-----|
B-----|E|---M------------X--|--TT----X---|------T--o--T-?-M?-B--o----X|-E--MM--?-o--o----?B-?-------?---------|-----o-o-BTE-X----------E|-T-------X-?-----?--M----E?X|------|M--|-E-o-XB----E--?-------v
?----X-|--------------TXM--E------B--o--M--M-E--X---X-----|---MX--To-----X------X--o--X-|--B--|M?XBT----E-X?------X?--o-|-X--------M----oB--------?|-o--XTo-----T-B-----B-------?-----T--------|--X---|o
M-M-M-------?--M-TB-----|--?-|-M--------B----------X-XT--oo?-|B-----X------|---M--o--o---?---?-----M----?-----M---E--B-MM-X-----T-E-----|---M------X-----E-----o-?----M??-Bo-----B-----M-o---E--------Xo
|-----|--B--X--------------?M|----|-------?---T--X-----E-----------o--|-------?-----||-----|--T---------------------B---o-----BM--M--M--EM-----X---?MM---M-T------X---M--X------M------T--o------------X
E-------o-|o-----------------------|----|------o-----------?T-------X?--------T-M-o-----|--------XTTo----T-----BE----MXo--o-o|---T------T-?---------E-?------X---T-?---?--?X|Bo----T|T----X?--o--E-----X
|------X-----M----T---B-----T--M----E------E---|--T--|---?-M?----|-|?|-M----E-B--EX-o---o-?|----oXT-?----?--ET---M-MM-T----X-XoT--------------?-T--X----------E------B-T--?E--o--?-|---XBX-----E----X|-T
|---?----T----|-X----TXX----X-----E?-oBE--X--B-B-o--|B---ToTE-E---|-----X-M----------------E-M----------?----M-------E|-----M---E------M--|------o--oB-M|o----?B--o----|M---o---X---B--T---oX-M-T-----X-
m--M-|----M---|-|--BM--o-----------?XXo----E--E---X?-M--X--B-oB---|----X-|E-------T--o-----M?--------TT-?o-----T---B-X--M---?------X----M?---oT|-------|-T-------------T----M------M--B------M---B----XB
XXXXXXXXXXXXXXXXXXXXXXXXXXXXXXXXXXXXXXXXXXXXXXXXXXXXXXXXXXXXXXXXXXXXXXXXXXXXXXXXXXXXXXXXXXXXXXXXXXXXXXXXXXXXXXXXXXXXXXXXXXXXXXXXXXXXXXXXXXXXXXXXXXXXXXXXXXXXXXXXXXXXXXXXXXXXXXXXXXXXXXXXXXXXXXXXXXXXXXXX
