-M---T---X---|---------------X----|--------T-----------X-?-?Mo----B--E----BB----X|M-----------T--X-|E|------EBX--M--E--B-B-BB--E-X-o----M---T-|--E-o-|-B-------------|X------------o-M---------M----E---
----MB--T---------T-------T?E---ET------X-M-------?------M-----------X--E-T--?---B----E|-----?-------T------M-----BM------------M---X---o--------?---EoX--TX?-?-EM----T---X------B---EM-------M--X-?-M|-
---X---?-----T|--T--X---o----E-oT-X--E--??--B-?-?-?X--------------M--EB---o--------T-------|--T-BB---|---------XMM-E---EM---o-----------------T-------X-E-BB---M--X---oM---?MM--B---B-------E---B-------
--B------X--|--o------BB---o--X-M?-E---M------EE----oM------T---------B-M---?-------XB---M----o---------T-----?---E--E---T----EX----EMo-E--To------?--E----B--?-----------TM--------EE-------E--Bo--MT--
-EM------M-----|----E------B---------------X-B---------M|-o--M------M?--E--o---------?----ToX-----M--?----T--T------?M--BT--M----M-B-X------X----M-|----BEM----------?----?oM---|-o-TT-T----|X----------
-?--?-ETX----X?-B---------B-----o-Eo-Eo-----T-------?B---BM-----B--o-----------B--o-Eo-|---B---E-X------T|MTB--------------------o----E---?T--------B---T---------X---T-?--o---E------|X---M---X--MBB---
------M-|---------T-o--T|--B----------o--|----M---------E-------T--|--|T---------EE----B---oB--T-----?-----M------------o|-XX-E-E-B--X---M-------X------M------MME-------M---o-B--M-E|--||-X-----X--o-T-
-------o------|X-EMMX----E--------TB------X--oT----o-X--------oM-M?-T--------M---T--Bo---EB--M--------E---MM---X-----------o---X-|-|------oE-----X------M-B--T--------o-XX--?-T---E---B-------BT-------v
--E---------E-----|--oE-o----B-------o----------------?T----B--T-----?--------X-BE-?X------------X-MX--|-----|-------|---o----B----------|--|---------B--M----E---oX--B------|T-----M--------o----T---Xf
--------||Mo-?M-oE-------oX?-----ETX-----M---Eo-B----Eoo------B-o---------o-------B-----EE-X---|-----------X----------o---o|-B--?o--Xo----XB--X|---T---T------EXo---X--MEB|-T----------------T--------Xf
-E----?T---B-----|----E-?--X-X--B---o?-X--B----B-------E----?-----?o----o----o-?-------MB------------B--|-|---M--------E----------M--------------o-----?X-----X----B---------o---E-M-?---E-M-----o-E-T-f
-E-M--MM----------|---?----o-M------|------TM---M-T------MM-----T--|-----B----X|B-------------?o---X-----X?---E--XM---------------------o----|---X------E--B--X-------E-|---T-T---------X-------|----B-f
-----MM----X--?-----?-|E--|----T--XE-----B----M-----?----E-----------?-?------B-M-MTT--?---Xo---|-BX----MX-----M-------|-M--------------E-------M-------EBE--o----M----?-----X-EoMB---?-TXM---?---|-o-Xf
-o-M-o-------?--o-----------|------B-X---EB----X?---ME-BB---Mo-o--BE--TB--|-M----|------------M--X|-----E-----------?------XT-o-B---o-----o---B-------Xo-----ME-X-----------E--M--o-----X-|-------?----f
m------?----M-----Bo----E-X----o--MT--------M---X---M-B--------oT-?E--B|---E-------?------E-M-o--o-----?-------Bo------------|-T----------?---B------T--E--------o---XX--MX------T--------B----E-|X-o--X
XXXXXXXXXXXXXXXXXXXXXXXXXXXXXXXXXXXXXXXXXXXXXXXXXXXXXXXXXXXXXXXXXXXXXXXXXXXXXXXXXXXXXXXXXXXXXXXXXXXXXXXXXXXXXXXXXXXXXXXXXXXXXXXXXXXXXXXXXXXXXXXXXXXXXXXXXXXXXXXXXXXXXXXXXXXXXXXXXXXXXXXXXXXXXXXXXXXXXXXX
