-----------------------------------------------------------------------------------------------------------------------------------------------------------------------------------------------------------------
------------------------------o------------------------X--------o-------------------X------------------B-----X-------------------o-------------------------------------------------------------------------------
---------------------------------------------------o-----------------------------o-------------------------------------------o----------------------------------B------------------------------------------------
--------------------------------------------o------------------------------------------------------o-o--------------BBXX-----------------------------------------?o------------o-------------o-------------------
------------------------?----------------------X-----BBB------------------o----------E------------------o---------------------------------------BBBB-------------------------------------------B-----------------
--------------X-----B---------BBB---------------------------BBB----------------BBXBBBB------------??-----------------------------------BBBX-----------BXBBBBB-------------------o-X------------------------------
----------------------------------------------------o----------------B----------------------BB------------B--BBXBBBBX--------------o--------E---------Xo------------------------------------X--------------------
------------------------------BXBBBBX-------XX----B-BB--------o----------------BXB-B-------------X-------------------------??--------------BXBBBXB-------------------------------o----X----------------v---------
-------------------?------------------------------o----------------------------E--o---------------XBBB---------------------------------------------T-E-------------------XXXXXXXX----------------------f---------
--------------------------------------------------T------XXXXXXX---X?XXX-----BBB------XBBB?BBB-----------?-???-----TXB-------BBB-------BBB--------B|BBXB-----------------------------------------------f---------
-------------E-E----------------------------------|---------------E--------E---------E------------------E----E--E--|E---------o-------E-E---E------|---------------------------------------------------f---------
-----------XBBBB-------------BBBBB-----XBBBBX-BBBB|BB--BBBB-------BBBXXXX-BBBBB--BBB-BBBBBBB--BBBBBBX-BBB?????--???|?-----BBBBB----B-BBBBBXXXX--BBB|B----BBBB----?X???-BBBB--------B-------?-----------f---------
--------------------------------------------------|------------------------------------------T--------------o------|------------------------X------|-T-------------------------------------------------f---------
-----------------------------o------------------X-|------------------------o-----------------|----o--o----------o--|-----------------------o-------|-|--------------------o----------------------------f---------
m-E------E---E-E-E------E--------EE-----E----E-E-E|E--E-----------E---EE-------E-EE-EE---EE--|-E-E-EEE--------E-EE-|E--EE--E------EE----E----------|-|----E--E-----E-------------E-----E---------------X---------
XXXXXXXXXXXXXXXXXXXXXXXXXXXXXXXXXXXXXXXXXXXXXXXXXXXXXXXXXXXXXXXXXXXXXXXXXXXXXXXXXXXXXXXXXXXXXXXXXXXXXXXXXXXXXXXXXXXXXXXXXXXXXXXXXXXXXXXXXXXXXXXXXXXXXXXXXXXXXXXXXXXXXXXXXXXXXXXXXXXXXXXXXXXXXXXXXXXXXXXXXXXXXXXXX
